1,2020-09-03,0,0,51,51,1461
1,2020-09-04,0,0,87,87,1548
1,2020-09-05,0,0,37,37,1585
1,2020-09-06,0,0,11,11,1596
1,2020-09-07,0,0,39,39,1635
1,2020-09-08,0,0,58,58,1693
1,2020-09-09,0,0,40,40,1733
1,2020-09-10,0,0,47,47,1780
1,2020-09-11,0,0,50,50,1830
1,2020-09-12,0,0,24,24,1854
1,2020-09-13,0,0,11,11,1865
1,2020-09-14,0,0,24,24,1889
1,2020-09-15,0,0,26,26,1915
1,2020-09-16,0,0,32,32,1947
1,2020-09-17,0,0,52,52,1999
1,2020-09-18,0,0,42,42,2041
1,2020-09-19,0,0,59,59,2100
1,2020-09-20,0,0,25,25,2125
1,2020-09-21,0,0,32,32,2157
1,2020-09-22,0,0,81,81,2238
1,2020-09-23,0,0,55,55,2293
1,2020-09-24,0,0,73,73,2366
1,2020-09-25,0,0,97,97,2463
1,2020-09-26,0,0,86,86,2549
1,2020-09-27,0,0,48,48,2597
1,2020-09-28,0,0,29,29,2626
1,2020-09-29,0,0,74,74,2700
1,2020-09-30,0,0,91,91,2791
1,2020-10-01,0,0,72,72,2863
1,2020-10-02,0,0,101,101,2964
1,2020-10-03,0,0,82,82,3046
1,2020-10-04,0,0,49,49,3095
1,2020-10-05,0,0,30,30,3125
1,2020-10-06,0,0,108,108,3233
1,2020-10-07,0,0,107,107,3340
1,2020-10-08,0,0,100,100,3440
1,2020-10-09,0,0,148,148,3588
1,2020-10-10,0,0,55,55,3643
1,2020-10-11,0,0,80,80,3723
1,2020-10-12,0,0,46,46,3769
1,2020-10-13,116,8,86,94,3863
1,2020-10-14,4,0,127,127,3990
1,2020-10-15,7,1,135,136,4126
1,2020-10-16,15,1,103,104,4230
1,2020-10-17,0,0,136,136,4366
1,2020-10-18,92,0,75,75,4441
1,2020-10-19,83,3,148,151,4592
1,2020-10-20,101,4,183,187,4779
1,2020-10-21,96,6,66,72,4851
1,2020-10-22,219,15,192,207,5058
1,2020-10-23,152,8,151,159,5217
1,2020-10-24,227,6,170,176,5393
1,2020-10-25,35,2,152,154,5547
1,2020-10-26,240,11,123,134,5681
1,2020-10-27,149,4,256,260,5941
1,2020-10-28,275,15,220,235,6176
1,2020-10-29,120,4,262,266,6442
1,2020-10-30,17488,138,158,296,6738
1,2020-10-31,22530,123,173,296,7034
1,2020-11-01,8733,39,227,266,7300
1,2020-11-02,3387,22,202,224,7524
1,2020-11-03,949,5,251,256,7780
1,2020-11-04,421,10,65,75,7855
1,2020-11-05,487,11,175,186,8041
1,2020-11-06,6466,25,281,306,8347
1,2020-11-07,4056,17,88,105,8452
1,2020-11-08,875,6,82,88,8540
1,2020-11-09,467,1,70,71,8611
1,2020-11-10,819,14,136,150,8761
1,2020-11-11,1441,12,159,171,8932
1,2020-11-12,1733,6,141,147,9079
1,2020-11-13,2117,21,94,115,9194
1,2020-11-14,1849,15,53,68,9262
1,2020-11-15,236,0,47,47,9309
1,2020-11-16,660,9,82,91,9400
1,2020-11-17,951,23,108,131,9531
1,2020-11-18,691,75,118,193,9724
1,2020-11-19,1016,29,173,202,9926
1,2020-11-20,2917,48,118,166,10092
1,2020-11-21,2173,47,109,156,10248
1,2020-11-22,88,7,36,43,10291
1,2020-11-23,418,13,67,80,10371
1,2020-11-24,3055,67,81,148,10519
1,2020-11-25,1164,31,140,171,10690
1,2020-11-26,1139,25,129,154,10844
1,2020-11-27,1227,29,54,83,10927
1,2020-11-28,2004,21,232,253,11180
1,2020-11-29,62,21,52,73,11253
1,2020-11-30,2184,123,152,275,11528
1,2020-12-01,3473,168,255,423,11951
1,2020-12-02,2587,83,204,287,12238
1,2020-12-03,5138,102,213,315,12553
1,2020-12-04,4615,104,200,304,12857
1,2020-12-05,2174,40,266,306,13163
1,2020-12-06,1636,52,61,113,13276
1,2020-12-07,4513,168,272,440,13716
1,2020-12-08,6113,213,234,447,14163
1,2020-12-09,4966,188,382,570,14733
1,2020-12-10,5310,222,286,508,15241
1,2020-12-11,7269,302,326,628,15869
1,2020-12-12,3891,157,361,518,16387
1,2020-12-13,115,7,125,132,16519
1,2020-12-14,6855,306,279,585,17104
1,2020-12-15,11170,488,423,911,18015
1,2020-12-16,10864,456,282,738,18753
1,2020-12-17,10367,403,502,905,19658
1,2020-12-18,10890,413,306,719,20377
1,2020-12-19,3279,129,396,525,20902
1,2020-12-20,688,54,180,234,21136
1,2020-12-21,16753,1998,392,2390,23526
1,2020-12-22,15702,762,327,1089,24615
1,2020-12-23,13305,491,416,907,25522
1,2020-12-24,3475,102,536,638,26160
1,2020-12-25,498,38,114,152,26312
1,2020-12-26,439,23,75,98,26410
1,2020-12-27,722,76,160,236,26646
1,2020-12-28,8167,559,255,814,27460
1,2020-12-29,10881,772,303,1075,28535
1,2020-12-30,9714,519,650,1169,29704
1,2020-12-31,14414,590,925,1515,31219
1,2021-01-01,3273,130,235,365,31584
1,2021-01-02,426,56,185,241,31825
1,2021-01-03,430,41,77,118,31943
1,2021-01-04,7740,598,601,1199,33142
1,2021-01-05,12199,832,619,1451,34593
1,2021-01-06,3234,216,271,487,35080
1,2021-01-07,7253,398,537,935,36015
1,2021-01-08,9258,425,556,981,36996
1,2021-01-09,5237,291,351,642,37638
1,2021-01-10,1420,79,252,331,37969
1,2021-01-11,19204,376,397,773,38742
1,2021-01-12,9898,463,450,913,39655
1,2021-01-13,8214,328,336,664,40319
1,2021-01-14,8351,273,363,636,40955
1,2021-01-15,7886,254,251,505,41460
1,2021-01-16,2905,156,70,226,41686
1,2021-01-17,436,26,244,270,41956
1,2021-01-18,12351,706,357,1063,43019
1,2021-01-19,13680,328,375,703,43722
1,2021-01-20,27175,453,360,813,44535
1,2021-01-21,105022,1292,255,1547,46082
1,2021-01-22,39582,341,199,540,46622
1,2021-01-23,74071,636,396,1032,47654
1,2021-01-24,34243,342,175,517,48171
1,2021-01-25,22181,230,356,586,48757
1,2021-01-26,22104,279,297,576,49333
1,2021-01-27,23049,348,336,684,50017
1,2021-01-28,10437,289,307,596,50613
1,2021-01-29,14885,323,82,405,51018
1,2021-01-30,38187,413,310,723,51741
1,2021-01-31,33122,375,180,555,52296
1,2021-02-01,37433,442,221,663,52959
1,2021-02-02,26715,407,397,804,53763
1,2021-02-03,11837,302,161,463,54226
1,2021-02-04,14675,320,555,875,55101
1,2021-02-05,24124,345,327,672,55773
1,2021-02-06,58933,478,116,594,56367
1,2021-02-07,46664,383,243,626,56993
1,2021-02-08,31244,359,484,843,57836
1,2021-02-09,32101,392,287,679,58515
1,2021-02-10,19578,305,314,619,59134
1,2021-02-11,21157,247,337,584,59718
1,2021-02-12,29447,252,282,534,60252
1,2021-02-13,53485,418,173,591,60843
1,2021-02-14,36069,241,153,394,61237
1,2021-02-15,31930,322,248,570,61807
1,2021-02-16,21960,252,289,541,62348
1,2021-02-17,18574,251,264,515,62863
2,2020-09-03,0,0,8,8,594
2,2020-09-04,0,0,16,16,610
2,2020-09-05,0,0,7,7,617
2,2020-09-06,0,0,5,5,622
2,2020-09-07,0,0,7,7,629
2,2020-09-08,0,0,11,11,640
2,2020-09-09,0,0,14,14,654
2,2020-09-10,0,0,32,32,686
2,2020-09-11,0,0,16,16,702
2,2020-09-12,0,0,12,12,714
2,2020-09-13,0,0,9,9,723
2,2020-09-14,0,0,26,26,749
2,2020-09-15,0,0,5,5,754
2,2020-09-16,0,0,49,49,803
2,2020-09-17,0,0,42,42,845
2,2020-09-18,0,0,33,33,878
2,2020-09-19,0,0,4,4,882
2,2020-09-20,0,0,17,17,899
2,2020-09-21,0,0,41,41,940
2,2020-09-22,0,0,55,55,995
2,2020-09-23,0,0,43,43,1038
2,2020-09-24,0,0,42,42,1080
2,2020-09-25,0,0,32,32,1112
2,2020-09-26,0,0,46,46,1158
2,2020-09-27,0,0,30,30,1188
2,2020-09-28,0,0,69,69,1257
2,2020-09-29,0,0,40,40,1297
2,2020-09-30,0,0,91,91,1388
2,2020-10-01,0,0,53,53,1441
2,2020-10-02,0,0,41,41,1482
2,2020-10-03,0,0,60,60,1542
2,2020-10-04,0,0,44,44,1586
2,2020-10-05,0,0,33,33,1619
2,2020-10-06,0,0,112,112,1731
2,2020-10-07,0,0,80,80,1811
2,2020-10-08,0,0,153,153,1964
2,2020-10-09,0,0,156,156,2120
2,2020-10-10,0,0,128,128,2248
2,2020-10-11,0,0,31,31,2279
2,2020-10-12,42,1,33,34,2313
2,2020-10-13,18,2,138,140,2453
2,2020-10-14,471,3,236,239,2692
2,2020-10-15,68,2,155,157,2849
2,2020-10-16,47,2,86,88,2937
2,2020-10-17,0,0,123,123,3060
2,2020-10-18,0,0,84,84,3144
2,2020-10-19,55,0,67,67,3211
2,2020-10-20,85,3,202,205,3416
2,2020-10-21,76,3,134,137,3553
2,2020-10-22,57,2,195,197,3750
2,2020-10-23,93,4,201,205,3955
2,2020-10-24,111,2,158,160,4115
2,2020-10-25,20,1,95,96,4211
2,2020-10-26,31,2,153,155,4366
2,2020-10-27,497,36,199,235,4601
2,2020-10-28,133,16,319,335,4936
2,2020-10-29,1477,16,273,289,5225
2,2020-10-30,3811,27,198,225,5450
2,2020-10-31,5065,41,259,300,5750
2,2020-11-01,521,27,87,114,5864
2,2020-11-02,1759,31,281,312,6176
2,2020-11-03,135,8,317,325,6501
2,2020-11-04,222,10,188,198,6699
2,2020-11-05,247,27,150,177,6876
2,2020-11-06,1550,19,260,279,7155
2,2020-11-07,6144,74,207,281,7436
2,2020-11-08,310,4,55,59,7495
2,2020-11-09,392,23,196,219,7714
2,2020-11-10,919,30,189,219,7933
2,2020-11-11,407,15,257,272,8205
2,2020-11-12,438,18,162,180,8385
2,2020-11-13,1333,21,219,240,8625
2,2020-11-14,399,10,86,96,8721
2,2020-11-15,77,4,23,27,8748
2,2020-11-16,714,32,187,219,8967
2,2020-11-17,767,72,129,201,9168
2,2020-11-18,791,75,235,310,9478
2,2020-11-19,752,58,157,215,9693
2,2020-11-20,1088,61,246,307,10000
2,2020-11-21,1237,23,129,152,10152
2,2020-11-22,57,3,10,13,10165
2,2020-11-23,7332,125,242,367,10532
2,2020-11-24,1863,91,295,386,10918
2,2020-11-25,1101,72,232,304,11222
2,2020-11-26,1044,59,234,293,11515
2,2020-11-27,1674,83,148,231,11746
2,2020-11-28,1530,77,83,160,11906
2,2020-11-29,742,34,17,51,11957
2,2020-11-30,7546,186,200,386,12343
2,2020-12-01,3395,205,253,458,12801
2,2020-12-02,4692,176,284,460,13261
2,2020-12-03,2960,190,248,438,13699
2,2020-12-04,4106,158,242,400,14099
2,2020-12-05,2259,41,129,170,14269
2,2020-12-06,0,0,46,46,14315
2,2020-12-07,3094,199,178,377,14692
2,2020-12-08,4394,304,281,585,15277
2,2020-12-09,4604,321,521,842,16119
2,2020-12-10,5514,320,183,503,16622
2,2020-12-11,4945,262,384,646,17268
2,2020-12-12,1570,114,254,368,17636
2,2020-12-13,0,0,7,7,17643
2,2020-12-14,3797,292,161,453,18096
2,2020-12-15,7254,632,492,1124,19220
2,2020-12-16,5654,405,312,717,19937
2,2020-12-17,5403,407,375,782,20719
2,2020-12-18,5269,378,341,719,21438
2,2020-12-19,1132,86,201,287,21725
2,2020-12-20,122,12,134,146,21871
2,2020-12-21,4926,399,328,727,22598
2,2020-12-22,6081,491,311,802,23400
2,2020-12-23,6792,375,210,585,23985
2,2020-12-24,1476,117,333,450,24435
2,2020-12-25,54,5,65,70,24505
2,2020-12-26,45,1,148,149,24654
2,2020-12-27,17,4,27,31,24685
2,2020-12-28,5932,612,213,825,25510
2,2020-12-29,5592,593,322,915,26425
2,2020-12-30,5933,612,785,1397,27822
2,2020-12-31,9346,858,498,1356,29178
2,2021-01-01,525,76,143,219,29397
2,2021-01-02,442,30,282,312,29709
2,2021-01-03,58,7,60,67,29776
2,2021-01-04,5924,689,302,991,30767
2,2021-01-05,6893,705,611,1316,32083
2,2021-01-06,890,132,179,311,32394
2,2021-01-07,4471,397,501,898,33292
2,2021-01-08,6851,502,381,883,34175
2,2021-01-09,1875,100,417,517,34692
2,2021-01-10,8,0,71,71,34763
2,2021-01-11,5287,376,370,746,35509
2,2021-01-12,7660,483,469,952,36461
2,2021-01-13,5130,378,457,835,37296
2,2021-01-14,4331,337,452,789,38085
2,2021-01-15,5802,336,278,614,38699
2,2021-01-16,618,19,103,122,38821
2,2021-01-17,1069,215,128,343,39164
2,2021-01-18,6721,484,247,731,39895
2,2021-01-19,7367,347,415,762,40657
2,2021-01-20,8423,274,503,777,41434
2,2021-01-21,14212,378,311,689,42123
2,2021-01-22,32939,500,217,717,42840
2,2021-01-23,118232,1336,372,1708,44548
2,2021-01-24,56355,703,91,794,45342
2,2021-01-25,44073,632,210,842,46184
2,2021-01-26,25995,650,565,1215,47399
2,2021-01-27,5520,219,433,652,48051
2,2021-01-28,6101,286,389,675,48726
2,2021-01-29,9848,284,196,480,49206
2,2021-01-30,111734,1279,323,1602,50808
2,2021-01-31,63506,778,19,797,51605
2,2021-02-01,40502,710,198,908,52513
2,2021-02-02,14246,415,446,861,53374
2,2021-02-03,6519,390,472,862,54236
2,2021-02-04,11242,551,456,1007,55243
2,2021-02-05,16272,354,377,731,55974
2,2021-02-06,113372,1473,348,1821,57795
2,2021-02-07,69464,627,140,767,58562
2,2021-02-08,34326,486,220,706,59268
2,2021-02-09,13114,366,544,910,60178
2,2021-02-10,9097,298,511,809,60987
2,2021-02-11,9993,345,422,767,61754
2,2021-02-12,23371,315,300,615,62369
2,2021-02-13,135650,967,218,1185,63554
2,2021-02-14,45191,343,51,394,63948
2,2021-02-15,16462,214,146,360,64308
2,2021-02-16,10762,253,426,679,64987
2,2021-02-17,7713,338,431,769,65756
3,2020-09-03,0,0,10,10,762
3,2020-09-04,0,0,9,9,771
3,2020-09-05,0,0,3,3,774
3,2020-09-06,0,0,1,1,775
3,2020-09-07,0,0,6,6,781
3,2020-09-08,0,0,12,12,793
3,2020-09-09,0,0,11,11,804
3,2020-09-10,0,0,15,15,819
3,2020-09-11,0,0,27,27,846
3,2020-09-12,0,0,2,2,848
3,2020-09-13,0,0,12,12,860
3,2020-09-14,0,0,5,5,865
3,2020-09-15,0,0,8,8,873
3,2020-09-16,0,0,14,14,887
3,2020-09-17,0,0,20,20,907
3,2020-09-18,0,0,41,41,948
3,2020-09-19,0,0,20,20,968
3,2020-09-20,0,0,21,21,989
3,2020-09-21,0,0,23,23,1012
3,2020-09-22,0,0,26,26,1038
3,2020-09-23,0,0,32,32,1070
3,2020-09-24,0,0,41,41,1111
3,2020-09-25,0,0,72,72,1183
3,2020-09-26,0,0,37,37,1220
3,2020-09-27,0,0,12,12,1232
3,2020-09-28,0,0,7,7,1239
3,2020-09-29,0,0,43,43,1282
3,2020-09-30,0,0,76,76,1358
3,2020-10-01,0,0,58,58,1416
3,2020-10-02,0,0,69,69,1485
3,2020-10-03,0,0,79,79,1564
3,2020-10-04,0,0,37,37,1601
3,2020-10-05,0,0,32,32,1633
3,2020-10-06,0,0,72,72,1705
3,2020-10-07,0,0,75,75,1780
3,2020-10-08,0,0,115,115,1895
3,2020-10-09,0,0,198,198,2093
3,2020-10-10,0,0,180,180,2273
3,2020-10-11,0,0,73,73,2346
3,2020-10-12,0,0,55,55,2401
3,2020-10-13,117,12,124,136,2537
3,2020-10-14,49,7,162,169,2706
3,2020-10-15,43,4,255,259,2965
3,2020-10-16,48,6,225,231,3196
3,2020-10-17,0,0,157,157,3353
3,2020-10-18,0,0,104,104,3457
3,2020-10-19,108,25,41,66,3523
3,2020-10-20,53,6,212,218,3741
3,2020-10-21,62,9,183,192,3933
3,2020-10-22,94,12,273,285,4218
3,2020-10-23,162,8,301,309,4527
3,2020-10-24,134,6,395,401,4928
3,2020-10-25,14,5,138,143,5071
3,2020-10-26,134,31,177,208,5279
3,2020-10-27,154,27,473,500,5779
3,2020-10-28,225,33,269,302,6081
3,2020-10-29,832,68,496,564,6645
3,2020-10-30,5385,102,299,401,7046
3,2020-10-31,4801,82,332,414,7460
3,2020-11-01,827,23,257,280,7740
3,2020-11-02,1901,68,197,265,8005
3,2020-11-03,105,8,575,583,8588
3,2020-11-04,100,9,370,379,8967
3,2020-11-05,113,15,399,414,9381
3,2020-11-06,6977,84,383,467,9848
3,2020-11-07,3721,59,319,378,10226
3,2020-11-08,1231,8,81,89,10315
3,2020-11-09,1455,48,115,163,10478
3,2020-11-10,112,6,277,283,10761
3,2020-11-11,123,10,366,376,11137
3,2020-11-12,129,5,324,329,11466
3,2020-11-13,144,13,308,321,11787
3,2020-11-14,85,11,190,201,11988
3,2020-11-15,35,6,109,115,12103
3,2020-11-16,281,45,245,290,12393
3,2020-11-17,121,15,222,237,12630
3,2020-11-18,445,66,233,299,12929
3,2020-11-19,853,113,316,429,13358
3,2020-11-20,954,93,316,409,13767
3,2020-11-21,1385,62,255,317,14084
3,2020-11-22,12,1,26,27,14111
3,2020-11-23,1308,122,159,281,14392
3,2020-11-24,2861,308,348,656,15048
3,2020-11-25,1604,160,322,482,15530
3,2020-11-26,1374,122,395,517,16047
3,2020-11-27,1548,150,330,480,16527
3,2020-11-28,1144,93,202,295,16822
3,2020-11-29,20,2,29,31,16853
3,2020-11-30,8983,489,167,656,17509
3,2020-12-01,5993,351,321,672,18181
3,2020-12-02,2076,232,418,650,18831
3,2020-12-03,1892,178,503,681,19512
3,2020-12-04,2734,215,253,468,19980
3,2020-12-05,815,64,223,287,20267
3,2020-12-06,189,10,114,124,20391
3,2020-12-07,4292,466,258,724,21115
3,2020-12-08,3962,522,546,1068,22183
3,2020-12-09,4275,470,508,978,23161
3,2020-12-10,3848,477,271,748,23909
3,2020-12-11,4381,479,750,1229,25138
3,2020-12-12,1122,120,314,434,25572
3,2020-12-13,28,4,77,81,25653
3,2020-12-14,3573,613,318,931,26584
3,2020-12-15,4299,656,595,1251,27835
3,2020-12-16,4947,622,461,1083,28918
3,2020-12-17,4193,503,670,1173,30091
3,2020-12-18,5213,543,521,1064,31155
3,2020-12-19,1761,150,341,491,31646
3,2020-12-20,12771,291,238,529,32175
3,2020-12-21,14535,996,248,1244,33419
3,2020-12-22,6291,694,673,1367,34786
3,2020-12-23,6923,629,421,1050,35836
3,2020-12-24,2450,256,552,808,36644
3,2020-12-25,372,47,251,298,36942
3,2020-12-26,84,10,174,184,37126
3,2020-12-27,238,36,5,41,37167
3,2020-12-28,4700,777,258,1035,38202
3,2020-12-29,6997,1018,459,1477,39679
3,2020-12-30,7544,762,836,1598,41277
3,2020-12-31,5500,557,597,1154,42431
3,2021-01-01,370,23,329,352,42783
3,2021-01-02,163,23,129,152,42935
3,2021-01-03,73,13,38,51,42986
3,2021-01-04,5401,704,337,1041,44027
3,2021-01-05,6785,800,669,1469,45496
3,2021-01-06,1085,64,221,285,45781
3,2021-01-07,6222,503,420,923,46704
3,2021-01-08,6878,467,489,956,47660
3,2021-01-09,8094,121,276,397,48057
3,2021-01-10,5015,76,89,165,48222
3,2021-01-11,4179,294,142,436,48658
3,2021-01-12,5083,293,508,801,49459
3,2021-01-13,4300,236,222,458,49917
3,2021-01-14,3144,153,275,428,50345
3,2021-01-15,3974,217,264,481,50826
3,2021-01-16,855,62,39,101,50927
3,2021-01-17,104,11,124,135,51062
3,2021-01-18,4745,257,72,329,51391
3,2021-01-19,6737,275,363,638,52029
3,2021-01-20,7920,236,181,417,52446
3,2021-01-21,9025,190,143,333,52779
3,2021-01-22,14122,174,148,322,53101
3,2021-01-23,110748,709,206,915,54016
3,2021-01-24,27546,181,51,232,54248
3,2021-01-25,34429,366,160,526,54774
3,2021-01-26,14524,237,303,540,55314
3,2021-01-27,11938,203,166,369,55683
3,2021-01-28,5592,161,307,468,56151
3,2021-01-29,7351,204,72,276,56427
3,2021-01-30,37400,355,228,583,57010
3,2021-01-31,15926,135,7,142,57152
3,2021-02-01,18545,318,167,485,57637
3,2021-02-02,8462,385,347,732,58369
3,2021-02-03,9326,345,162,507,58876
3,2021-02-04,7184,293,266,559,59435
3,2021-02-05,17372,364,202,566,60001
3,2021-02-06,63855,580,216,796,60797
3,2021-02-07,25968,262,31,293,61090
3,2021-02-08,28880,414,182,596,61686
3,2021-02-09,21884,379,514,893,62579
3,2021-02-10,11716,321,304,625,63204
3,2021-02-11,11522,320,291,611,63815
3,2021-02-12,26590,400,276,676,64491
3,2021-02-13,66190,576,274,850,65341
3,2021-02-14,5647,53,2,55,65396
3,2021-02-15,21891,453,151,604,66000
3,2021-02-16,17177,384,488,872,66872
3,2021-02-17,11264,357,363,720,67592
4,2020-09-03,0,0,15,15,463
4,2020-09-04,0,0,34,34,497
4,2020-09-05,0,0,22,22,519
4,2020-09-07,0,0,17,17,536
4,2020-09-08,0,0,17,17,553
4,2020-09-09,0,0,19,19,572
4,2020-09-10,0,0,29,29,601
4,2020-09-11,0,0,23,23,624
4,2020-09-12,0,0,12,12,636
4,2020-09-13,0,0,3,3,639
4,2020-09-14,0,0,28,28,667
4,2020-09-15,0,0,19,19,686
4,2020-09-16,0,0,6,6,692
4,2020-09-17,0,0,30,30,722
4,2020-09-18,0,0,19,19,741
4,2020-09-19,0,0,14,14,755
4,2020-09-20,0,0,4,4,759
4,2020-09-21,0,0,10,10,769
4,2020-09-22,0,0,18,18,787
4,2020-09-23,0,0,70,70,857
4,2020-09-24,0,0,51,51,908
4,2020-09-25,0,0,90,90,998
4,2020-09-26,0,0,64,64,1062
4,2020-09-27,0,0,16,16,1078
4,2020-09-28,0,0,22,22,1100
4,2020-09-29,0,0,50,50,1150
4,2020-09-30,0,0,100,100,1250
4,2020-10-01,0,0,95,95,1345
4,2020-10-02,0,0,108,108,1453
4,2020-10-03,0,0,96,96,1549
4,2020-10-04,0,0,17,17,1566
4,2020-10-05,0,0,20,20,1586
4,2020-10-06,0,0,48,48,1634
4,2020-10-07,0,0,81,81,1715
4,2020-10-08,0,0,132,132,1847
4,2020-10-09,0,0,120,120,1967
4,2020-10-10,0,0,107,107,2074
4,2020-10-11,0,0,8,8,2082
4,2020-10-12,0,0,36,36,2118
4,2020-10-13,84,2,101,103,2221
4,2020-10-14,26,4,80,84,2305
4,2020-10-15,33,2,106,108,2413
4,2020-10-16,31,3,133,136,2549
4,2020-10-17,0,0,67,67,2616
4,2020-10-18,0,0,22,22,2638
4,2020-10-19,80,1,148,149,2787
4,2020-10-20,84,6,197,203,2990
4,2020-10-21,211,3,146,149,3139
4,2020-10-22,483,39,137,176,3315
4,2020-10-23,803,41,282,323,3638
4,2020-10-24,248,11,169,180,3818
4,2020-10-25,46,6,50,56,3874
4,2020-10-26,689,56,69,125,3999
4,2020-10-27,597,47,296,343,4342
4,2020-10-28,667,59,216,275,4617
4,2020-10-29,880,39,293,332,4949
4,2020-10-30,2401,21,204,225,5174
4,2020-10-31,10600,134,261,395,5569
4,2020-11-01,2573,27,130,157,5726
4,2020-11-02,4254,46,171,217,5943
4,2020-11-03,460,25,216,241,6184
4,2020-11-04,313,16,211,227,6411
4,2020-11-05,307,12,178,190,6601
4,2020-11-06,2296,32,210,242,6843
4,2020-11-07,1050,4,130,134,6977
4,2020-11-08,1494,32,43,75,7052
4,2020-11-09,3179,43,128,171,7223
4,2020-11-10,2662,39,192,231,7454
4,2020-11-11,1269,22,279,301,7755
4,2020-11-12,1230,35,256,291,8046
4,2020-11-13,982,46,210,256,8302
4,2020-11-14,1163,32,114,146,8448
4,2020-11-15,11,1,14,15,8463
4,2020-11-16,1911,75,139,214,8677
4,2020-11-17,625,29,178,207,8884
4,2020-11-18,2186,77,188,265,9149
4,2020-11-19,3086,133,185,318,9467
4,2020-11-20,4121,101,264,365,9832
4,2020-11-21,1121,38,86,124,9956
4,2020-11-22,0,0,7,7,9963
4,2020-11-23,9768,206,102,308,10271
4,2020-11-24,1191,50,147,197,10468
4,2020-11-25,2059,66,325,391,10859
4,2020-11-26,2319,57,191,248,11107
4,2020-11-27,1272,43,177,220,11327
4,2020-11-28,923,31,135,166,11493
4,2020-11-29,662,42,3,45,11538
4,2020-11-30,5043,207,91,298,11836
4,2020-12-01,3074,133,331,464,12300
4,2020-12-02,3896,163,252,415,12715
4,2020-12-03,2726,127,248,375,13090
4,2020-12-04,3133,86,232,318,13408
4,2020-12-05,632,14,136,150,13558
4,2020-12-06,93,4,15,19,13577
4,2020-12-07,6816,573,139,712,14289
4,2020-12-08,9377,611,340,951,15240
4,2020-12-09,6268,542,362,904,16144
4,2020-12-10,5356,326,360,686,16830
4,2020-12-11,6658,465,409,874,17704
4,2020-12-12,1957,125,341,466,18170
4,2020-12-13,10,1,12,13,18183
4,2020-12-14,8916,827,217,1044,19227
4,2020-12-15,10134,769,461,1230,20457
4,2020-12-16,9216,546,357,903,21360
4,2020-12-17,7219,514,586,1100,22460
4,2020-12-18,8871,551,512,1063,23523
4,2020-12-19,2418,159,262,421,23944
4,2020-12-20,60,10,77,87,24031
4,2020-12-21,8695,976,128,1104,25135
4,2020-12-22,11909,994,673,1667,26802
4,2020-12-23,16057,843,349,1192,27994
4,2020-12-24,2037,176,514,690,28684
4,2020-12-25,52,5,35,40,28724
4,2020-12-26,353,56,54,110,28834
4,2020-12-27,38,2,22,24,28858
4,2020-12-28,8152,1271,83,1354,30212
4,2020-12-29,9461,1286,607,1893,32105
4,2020-12-30,10590,1160,1094,2254,34359
4,2020-12-31,8608,962,786,1748,36107
4,2021-01-01,765,94,119,213,36320
4,2021-01-02,1116,26,249,275,36595
4,2021-01-03,104,20,42,62,36657
4,2021-01-04,9517,1270,362,1632,38289
4,2021-01-05,10019,1204,732,1936,40225
4,2021-01-06,3586,239,259,498,40723
4,2021-01-07,11249,784,438,1222,41945
4,2021-01-08,14723,719,817,1536,43481
4,2021-01-09,38165,1090,532,1622,45103
4,2021-01-10,20571,730,44,774,45877
4,2021-01-11,8690,515,422,937,46814
4,2021-01-12,9566,574,642,1216,48030
4,2021-01-13,9664,497,663,1160,49190
4,2021-01-14,10708,440,627,1067,50257
4,2021-01-15,16131,465,373,838,51095
4,2021-01-16,37019,654,64,718,51813
4,2021-01-17,15336,275,97,372,52185
4,2021-01-18,8973,494,367,861,53046
4,2021-01-19,11401,623,344,967,54013
4,2021-01-20,12122,612,326,938,54951
4,2021-01-21,14715,406,305,711,55662
4,2021-01-22,35839,607,139,746,56408
4,2021-01-23,105597,1580,277,1857,58265
4,2021-01-24,65411,642,12,654,58919
4,2021-01-25,24101,443,201,644,59563
4,2021-01-26,17636,461,345,806,60369
4,2021-01-27,13694,380,235,615,60984
4,2021-01-28,11323,372,269,641,61625
4,2021-01-29,24023,475,135,610,62235
4,2021-01-30,78911,768,152,920,63155
4,2021-01-31,22821,240,9,249,63404
4,2021-02-01,24770,448,221,669,64073
4,2021-02-02,17758,365,327,692,64765
4,2021-02-03,11038,330,191,521,65286
4,2021-02-04,16155,500,308,808,66094
4,2021-02-05,34907,616,244,860,66954
4,2021-02-06,96018,828,129,957,67911
4,2021-02-07,49225,467,20,487,68398
4,2021-02-08,44303,657,177,834,69232
4,2021-02-09,18978,382,260,642,69874
4,2021-02-10,18256,642,186,828,70702
4,2021-02-11,12636,271,195,466,71168
4,2021-02-12,33160,398,162,560,71728
4,2021-02-13,99269,545,127,672,72400
4,2021-02-14,33924,192,8,200,72600
4,2021-02-15,24550,431,122,553,73153
4,2021-02-16,23837,383,284,667,73820
4,2021-02-17,10727,262,198,460,74280
5,2020-09-03,0,0,18,18,676
5,2020-09-04,0,0,33,33,709
5,2020-09-05,0,0,2,2,711
5,2020-09-07,0,0,11,11,722
5,2020-09-08,0,0,25,25,747
5,2020-09-09,0,0,23,23,770
5,2020-09-10,0,0,31,31,801
5,2020-09-11,0,0,31,31,832
5,2020-09-12,0,0,4,4,836
5,2020-09-13,0,0,6,6,842
5,2020-09-14,0,0,39,39,881
5,2020-09-15,0,0,12,12,893
5,2020-09-16,0,0,34,34,927
5,2020-09-17,0,0,30,30,957
5,2020-09-18,0,0,82,82,1039
5,2020-09-19,0,0,6,6,1045
5,2020-09-20,0,0,4,4,1049
5,2020-09-21,0,0,47,47,1096
5,2020-09-22,0,0,65,65,1161
5,2020-09-23,0,0,65,65,1226
5,2020-09-24,0,0,100,100,1326
5,2020-09-25,0,0,69,69,1395
5,2020-09-26,0,0,96,96,1491
5,2020-09-27,0,0,108,108,1599
5,2020-09-28,0,0,34,34,1633
5,2020-09-29,0,0,105,105,1738
5,2020-09-30,0,0,163,163,1901
5,2020-10-01,0,0,147,147,2048
5,2020-10-02,0,0,105,105,2153
5,2020-10-03,0,0,155,155,2308
5,2020-10-04,0,0,35,35,2343
5,2020-10-05,0,0,33,33,2376
5,2020-10-06,0,0,233,233,2609
5,2020-10-07,0,0,168,168,2777
5,2020-10-08,0,0,238,238,3015
5,2020-10-09,0,0,543,543,3558
5,2020-10-10,0,0,213,213,3771
5,2020-10-11,0,0,50,50,3821
5,2020-10-12,0,0,62,62,3883
5,2020-10-13,498,40,367,407,4290
5,2020-10-14,275,6,523,529,4819
5,2020-10-15,64,3,679,682,5501
5,2020-10-16,60,9,603,612,6113
5,2020-10-17,0,0,509,509,6622
5,2020-10-18,0,0,159,159,6781
5,2020-10-19,92,12,70,82,6863
5,2020-10-20,135,8,524,532,7395
5,2020-10-21,88,14,478,492,7887
5,2020-10-22,36,3,525,528,8415
5,2020-10-23,115,13,659,672,9087
5,2020-10-24,0,0,803,803,9890
5,2020-10-25,0,0,436,436,10326
5,2020-10-26,145,28,148,176,10502
5,2020-10-27,178,24,355,379,10881
5,2020-10-28,116,11,635,646,11527
5,2020-10-29,520,17,740,757,12284
5,2020-10-30,2636,61,529,590,12874
5,2020-10-31,8166,203,662,865,13739
5,2020-11-01,5226,130,349,479,14218
5,2020-11-02,1082,39,472,511,14729
5,2020-11-03,905,16,688,704,15433
5,2020-11-04,178,10,423,433,15866
5,2020-11-05,68,4,473,477,16343
5,2020-11-06,4128,38,503,541,16884
5,2020-11-07,8263,88,312,400,17284
5,2020-11-08,2231,35,59,94,17378
5,2020-11-09,2365,30,143,173,17551
5,2020-11-10,528,9,374,383,17934
5,2020-11-11,157,10,489,499,18433
5,2020-11-12,81,2,334,336,18769
5,2020-11-13,134,9,181,190,18959
5,2020-11-14,1049,11,189,200,19159
5,2020-11-15,13,0,63,63,19222
5,2020-11-16,219,13,227,240,19462
5,2020-11-17,505,15,123,138,19600
5,2020-11-18,363,15,346,361,19961
5,2020-11-19,813,61,252,313,20274
5,2020-11-20,1119,45,251,296,20570
5,2020-11-21,525,20,61,81,20651
5,2020-11-22,0,0,11,11,20662
5,2020-11-23,803,44,170,214,20876
5,2020-11-24,2159,67,213,280,21156
5,2020-11-25,1266,49,225,274,21430
5,2020-11-26,1161,57,189,246,21676
5,2020-11-27,959,46,218,264,21940
5,2020-11-28,364,15,99,114,22054
5,2020-11-29,88,7,18,25,22079
5,2020-11-30,5523,291,202,493,22572
5,2020-12-01,6838,309,209,518,23090
5,2020-12-02,1635,82,181,263,23353
5,2020-12-03,1531,119,237,356,23709
5,2020-12-04,2967,120,228,348,24057
5,2020-12-05,1282,45,98,143,24200
5,2020-12-06,138,4,15,19,24219
5,2020-12-07,2395,121,348,469,24688
5,2020-12-08,4103,188,331,519,25207
5,2020-12-09,2722,163,392,555,25762
5,2020-12-10,10256,849,166,1015,26777
5,2020-12-11,4878,282,455,737,27514
5,2020-12-12,1114,53,95,148,27662
5,2020-12-13,579,64,26,90,27752
5,2020-12-14,4759,358,321,679,28431
5,2020-12-15,4786,387,528,915,29346
5,2020-12-16,4670,305,333,638,29984
5,2020-12-17,4614,281,500,781,30765
5,2020-12-18,7429,402,333,735,31500
5,2020-12-19,2224,144,208,352,31852
5,2020-12-20,652,73,36,109,31961
5,2020-12-21,13810,1107,444,1551,33512
5,2020-12-22,14211,1023,519,1542,35054
5,2020-12-23,18270,1012,228,1240,36294
5,2020-12-24,1093,75,643,718,37012
5,2020-12-25,121,10,66,76,37088
5,2020-12-26,138,14,135,149,37237
5,2020-12-27,742,80,40,120,37357
5,2020-12-28,11772,1002,406,1408,38765
5,2020-12-29,11870,1070,256,1326,40091
5,2020-12-30,13017,860,1038,1898,41989
5,2020-12-31,11181,833,395,1228,43217
5,2021-01-01,588,36,118,154,43371
5,2021-01-02,832,86,98,184,43555
5,2021-01-03,37,4,13,17,43572
5,2021-01-04,10498,949,479,1428,45000
5,2021-01-05,12239,929,717,1646,46646
5,2021-01-06,1427,89,145,234,46880
5,2021-01-07,25524,1880,438,2318,49198
5,2021-01-08,9863,511,413,924,50122
5,2021-01-09,2077,85,192,277,50399
5,2021-01-10,196,7,38,45,50444
5,2021-01-11,10995,510,351,861,51305
5,2021-01-12,9350,426,376,802,52107
5,2021-01-13,11895,554,247,801,52908
5,2021-01-14,5890,253,166,419,53327
5,2021-01-15,7351,202,248,450,53777
5,2021-01-16,322,8,14,22,53799
5,2021-01-17,115,2,95,97,53896
5,2021-01-18,12821,334,236,570,54466
5,2021-01-19,17975,405,245,650,55116
5,2021-01-20,17123,165,236,401,55517
5,2021-01-21,19529,178,116,294,55811
5,2021-01-22,28275,228,163,391,56202
5,2021-01-23,88501,395,91,486,56688
5,2021-01-24,32610,138,22,160,56848
5,2021-01-25,18746,131,159,290,57138
5,2021-01-26,49746,342,245,587,57725
5,2021-01-27,7100,123,256,379,58104
5,2021-01-28,5772,174,240,414,58518
5,2021-01-29,17426,214,30,244,58762
5,2021-01-30,15533,156,85,241,59003
5,2021-01-31,43,1,11,12,59015
5,2021-02-01,18961,334,220,554,59569
5,2021-02-02,10087,280,216,496,60065
5,2021-02-03,9002,252,194,446,60511
5,2021-02-04,11539,232,238,470,60981
5,2021-02-05,30832,293,248,541,61522
5,2021-02-06,66568,325,71,396,61918
5,2021-02-07,38639,199,24,223,62141
5,2021-02-08,43823,408,160,568,62709
5,2021-02-09,25199,278,377,655,63364
5,2021-02-10,17038,259,259,518,63882
5,2021-02-11,23754,293,228,521,64403
5,2021-02-12,41514,330,242,572,64975
5,2021-02-13,65302,432,91,523,65498
5,2021-02-14,20509,180,30,210,65708
5,2021-02-15,32530,316,230,546,66254
5,2021-02-16,23647,324,321,645,66899
5,2021-02-17,17650,331,269,600,67499
6,2020-09-03,0,0,5,5,308
6,2020-09-04,0,0,9,9,317
6,2020-09-07,0,0,2,2,319
6,2020-09-08,0,0,5,5,324
6,2020-09-09,0,0,13,13,337
6,2020-09-10,0,0,11,11,348
6,2020-09-11,0,0,19,19,367
6,2020-09-12,0,0,5,5,372
6,2020-09-13,0,0,1,1,373
6,2020-09-14,0,0,13,13,386
6,2020-09-15,0,0,2,2,388
6,2020-09-16,0,0,6,6,394
6,2020-09-17,0,0,14,14,408
6,2020-09-18,0,0,24,24,432
6,2020-09-19,0,0,3,3,435
6,2020-09-21,0,0,3,3,438
6,2020-09-22,0,0,25,25,463
6,2020-09-23,0,0,17,17,480
6,2020-09-24,0,0,25,25,505
6,2020-09-25,0,0,29,29,534
6,2020-09-26,0,0,24,24,558
6,2020-09-27,0,0,20,20,578
6,2020-09-29,0,0,24,24,602
6,2020-09-30,0,0,60,60,662
6,2020-10-01,0,0,49,49,711
6,2020-10-02,0,0,74,74,785
6,2020-10-03,0,0,37,37,822
6,2020-10-04,0,0,8,8,830
6,2020-10-05,0,0,49,49,879
6,2020-10-06,0,0,68,68,947
6,2020-10-07,0,0,124,124,1071
6,2020-10-08,0,0,99,99,1170
6,2020-10-09,0,0,128,128,1298
6,2020-10-10,0,0,53,53,1351
6,2020-10-11,0,0,14,14,1365
6,2020-10-12,13,0,11,11,1376
6,2020-10-13,180,11,151,162,1538
6,2020-10-14,32,1,139,140,1678
6,2020-10-15,30,1,133,134,1812
6,2020-10-16,40,3,224,227,2039
6,2020-10-17,0,0,91,91,2130
6,2020-10-18,0,0,49,49,2179
6,2020-10-19,83,12,27,39,2218
6,2020-10-20,69,3,210,213,2431
6,2020-10-21,269,3,209,212,2643
6,2020-10-22,277,24,264,288,2931
6,2020-10-23,259,29,231,260,3191
6,2020-10-24,126,12,315,327,3518
6,2020-10-25,151,11,50,61,3579
6,2020-10-26,261,29,38,67,3646
6,2020-10-27,694,40,266,306,3952
6,2020-10-28,332,30,285,315,4267
6,2020-10-29,1011,42,372,414,4681
6,2020-10-30,2849,20,254,274,4955
6,2020-10-31,13632,116,198,314,5269
6,2020-11-01,2713,42,101,143,5412
6,2020-11-02,2312,65,90,155,5567
6,2020-11-03,1336,4,246,250,5817
6,2020-11-04,1379,13,254,267,6084
6,2020-11-05,296,33,240,273,6357
6,2020-11-06,2512,16,227,243,6600
6,2020-11-07,8922,94,164,258,6858
6,2020-11-08,799,16,82,98,6956
6,2020-11-09,2709,31,80,111,7067
6,2020-11-10,481,18,263,281,7348
6,2020-11-11,446,9,224,233,7581
6,2020-11-12,996,44,218,262,7843
6,2020-11-13,563,11,157,168,8011
6,2020-11-14,307,2,73,75,8086
6,2020-11-15,66,2,52,54,8140
6,2020-11-16,373,22,106,128,8268
6,2020-11-17,613,35,52,87,8355
6,2020-11-18,649,62,153,215,8570
6,2020-11-19,1194,82,170,252,8822
6,2020-11-20,1977,105,127,232,9054
6,2020-11-21,899,14,52,66,9120
6,2020-11-22,73,1,38,39,9159
6,2020-11-23,10139,191,66,257,9416
6,2020-11-24,2329,67,166,233,9649
6,2020-11-25,1844,84,170,254,9903
6,2020-11-26,1946,91,209,300,10203
6,2020-11-27,2050,120,219,339,10542
6,2020-11-28,1327,48,81,129,10671
6,2020-11-29,83,3,19,22,10693
6,2020-11-30,3987,226,75,301,10994
6,2020-12-01,2753,134,215,349,11343
6,2020-12-02,4478,186,217,403,11746
6,2020-12-03,3140,227,240,467,12213
6,2020-12-04,3897,174,339,513,12726
6,2020-12-05,985,33,109,142,12868
6,2020-12-06,368,9,121,130,12998
6,2020-12-07,2146,140,175,315,13313
6,2020-12-08,3943,276,256,532,13845
6,2020-12-09,3919,212,323,535,14380
6,2020-12-10,5378,351,280,631,15011
6,2020-12-11,6817,374,468,842,15853
6,2020-12-12,2732,138,137,275,16128
6,2020-12-13,20,1,122,123,16251
6,2020-12-14,3992,259,148,407,16658
6,2020-12-15,5748,430,336,766,17424
6,2020-12-16,10637,557,379,936,18360
6,2020-12-17,9246,772,468,1240,19600
6,2020-12-18,6868,414,432,846,20446
6,2020-12-19,3053,135,170,305,20751
6,2020-12-20,113,14,155,169,20920
6,2020-12-21,5346,448,286,734,21654
6,2020-12-22,9058,624,307,931,22585
6,2020-12-23,10617,507,368,875,23460
6,2020-12-24,3809,135,452,587,24047
6,2020-12-25,235,6,65,71,24118
6,2020-12-26,291,32,61,93,24211
6,2020-12-27,521,25,116,141,24352
6,2020-12-28,6362,703,131,834,25186
6,2020-12-29,8507,738,240,978,26164
6,2020-12-30,7959,550,593,1143,27307
6,2020-12-31,7462,719,499,1218,28525
6,2021-01-01,2150,135,220,355,28880
6,2021-01-02,666,83,123,206,29086
6,2021-01-03,175,13,199,212,29298
6,2021-01-04,6333,571,130,701,29999
6,2021-01-05,6860,480,372,852,30851
6,2021-01-06,3579,210,305,515,31366
6,2021-01-07,4297,260,127,387,31753
6,2021-01-08,8459,383,435,818,32571
6,2021-01-09,2835,107,297,404,32975
6,2021-01-10,106,4,110,114,33089
6,2021-01-11,7445,411,76,487,33576
6,2021-01-12,6585,287,194,481,34057
6,2021-01-13,5751,191,235,426,34483
6,2021-01-14,5763,320,220,540,35023
6,2021-01-15,6515,203,164,367,35390
6,2021-01-16,1929,56,58,114,35504
6,2021-01-17,8227,77,110,187,35691
6,2021-01-18,5448,277,94,371,36062
6,2021-01-19,10967,321,213,534,36596
6,2021-01-20,9046,186,231,417,37013
6,2021-01-21,16360,351,194,545,37558
6,2021-01-22,27140,341,175,516,38074
6,2021-01-23,84113,503,142,645,38719
6,2021-01-24,29506,239,38,277,38996
6,2021-01-25,31746,369,82,451,39447
6,2021-01-26,19961,288,238,526,39973
6,2021-01-27,10828,197,191,388,40361
6,2021-01-28,14146,342,218,560,40921
6,2021-01-29,15431,237,130,367,41288
6,2021-01-30,46470,379,163,542,41830
6,2021-01-31,24720,219,34,253,42083
6,2021-02-01,19451,379,75,454,42537
6,2021-02-02,14984,319,277,596,43133
6,2021-02-03,9303,243,350,593,43726
6,2021-02-04,13583,413,240,653,44379
6,2021-02-05,23914,358,282,640,45019
6,2021-02-06,63572,545,178,723,45742
6,2021-02-07,23673,142,70,212,45954
6,2021-02-08,41535,589,103,692,46646
6,2021-02-09,17851,349,329,678,47324
6,2021-02-10,13858,320,333,653,47977
6,2021-02-11,21721,384,305,689,48666
6,2021-02-12,35403,521,312,833,49499
6,2021-02-13,42420,399,202,601,50100
6,2021-02-14,14937,127,60,187,50287
6,2021-02-15,35028,554,118,672,50959
6,2021-02-16,20596,380,338,718,51677
6,2021-02-17,16148,384,415,799,52476
7,2020-09-03,0,0,8,8,591
7,2020-09-04,0,0,24,24,615
7,2020-09-05,0,0,7,7,622
7,2020-09-06,0,0,3,3,625
7,2020-09-07,0,0,5,5,630
7,2020-09-08,0,0,23,23,653
7,2020-09-09,0,0,21,21,674
7,2020-09-10,0,0,10,10,684
7,2020-09-11,0,0,15,15,699
7,2020-09-12,0,0,4,4,703
7,2020-09-13,0,0,3,3,706
7,2020-09-14,0,0,47,47,753
7,2020-09-15,0,0,10,10,763
7,2020-09-16,0,0,8,8,771
7,2020-09-17,0,0,25,25,796
7,2020-09-18,0,0,29,29,825
7,2020-09-19,0,0,12,12,837
7,2020-09-20,0,0,5,5,842
7,2020-09-21,0,0,14,14,856
7,2020-09-22,0,0,29,29,885
7,2020-09-23,0,0,55,55,940
7,2020-09-24,0,0,52,52,992
7,2020-09-25,0,0,91,91,1083
7,2020-09-26,0,0,72,72,1155
7,2020-09-27,0,0,10,10,1165
7,2020-09-28,0,0,51,51,1216
7,2020-09-29,0,0,156,156,1372
7,2020-09-30,0,0,121,121,1493
7,2020-10-01,0,0,136,136,1629
7,2020-10-02,0,0,149,149,1778
7,2020-10-03,0,0,204,204,1982
7,2020-10-04,0,0,118,118,2100
7,2020-10-05,0,0,84,84,2184
7,2020-10-06,0,0,166,166,2350
7,2020-10-07,0,0,244,244,2594
7,2020-10-08,0,0,245,245,2839
7,2020-10-09,0,0,406,406,3245
7,2020-10-10,0,0,248,248,3493
7,2020-10-11,0,0,127,127,3620
7,2020-10-12,369,35,214,249,3869
7,2020-10-13,56,6,264,270,4139
7,2020-10-14,64,10,451,461,4600
7,2020-10-15,103,18,435,453,5053
7,2020-10-16,60,3,388,391,5444
7,2020-10-17,0,0,342,342,5786
7,2020-10-18,0,0,209,209,5995
7,2020-10-19,250,15,140,155,6150
7,2020-10-20,72,7,493,500,6650
7,2020-10-21,66,8,383,391,7041
7,2020-10-22,426,30,646,676,7717
7,2020-10-23,226,8,750,758,8475
7,2020-10-24,212,12,719,731,9206
7,2020-10-25,357,11,237,248,9454
7,2020-10-26,420,57,137,194,9648
7,2020-10-27,302,34,656,690,10338
7,2020-10-28,337,46,617,663,11001
7,2020-10-29,339,38,594,632,11633
7,2020-10-30,3014,65,552,617,12250
7,2020-10-31,10667,170,315,485,12735
7,2020-11-01,2959,53,386,439,13174
7,2020-11-02,5162,1004,203,1207,14381
7,2020-11-03,110,12,565,577,14958
7,2020-11-04,815,8,350,358,15316
7,2020-11-05,185,5,397,402,15718
7,2020-11-06,4867,76,520,596,16314
7,2020-11-07,8659,81,416,497,16811
7,2020-11-08,2849,32,97,129,16940
7,2020-11-09,5051,945,190,1135,18075
7,2020-11-10,206,9,437,446,18521
7,2020-11-11,176,15,516,531,19052
7,2020-11-12,279,50,397,447,19499
7,2020-11-13,174,8,395,403,19902
7,2020-11-14,58,4,261,265,20167
7,2020-11-15,43,4,186,190,20357
7,2020-11-16,433,51,226,277,20634
7,2020-11-17,168,17,347,364,20998
7,2020-11-18,405,32,270,302,21300
7,2020-11-19,2202,229,359,588,21888
7,2020-11-20,2161,98,363,461,22349
7,2020-11-21,746,57,205,262,22611
7,2020-11-22,31,1,46,47,22658
7,2020-11-23,884,42,164,206,22864
7,2020-11-24,1802,140,365,505,23369
7,2020-11-25,1720,78,302,380,23749
7,2020-11-26,3099,312,263,575,24324
7,2020-11-27,2254,119,232,351,24675
7,2020-11-28,744,62,199,261,24936
7,2020-11-29,421,42,27,69,25005
7,2020-11-30,5931,110,196,306,25311
7,2020-12-01,2554,213,281,494,25805
7,2020-12-02,3486,235,232,467,26272
7,2020-12-03,3102,202,284,486,26758
7,2020-12-04,4752,281,352,633,27391
7,2020-12-05,1071,87,218,305,27696
7,2020-12-06,384,26,59,85,27781
7,2020-12-07,3981,281,309,590,28371
7,2020-12-08,7083,647,350,997,29368
7,2020-12-09,3916,270,358,628,29996
7,2020-12-10,5620,440,337,777,30773
7,2020-12-11,6460,418,560,978,31751
7,2020-12-12,2640,166,319,485,32236
7,2020-12-13,37,8,89,97,32333
7,2020-12-14,6275,508,334,842,33175
7,2020-12-15,6269,584,411,995,34170
7,2020-12-16,6525,508,466,974,35144
7,2020-12-17,11717,891,427,1318,36462
7,2020-12-18,9449,599,396,995,37457
7,2020-12-19,1809,151,276,427,37884
7,2020-12-20,416,20,184,204,38088
7,2020-12-21,10216,820,432,1252,39340
7,2020-12-22,9471,666,439,1105,40445
7,2020-12-23,11010,576,361,937,41382
7,2020-12-24,1299,85,452,537,41919
7,2020-12-25,286,13,208,221,42140
7,2020-12-26,188,12,64,76,42216
7,2020-12-27,610,39,40,79,42295
7,2020-12-28,9312,1020,393,1413,43708
7,2020-12-29,9149,863,435,1298,45006
7,2020-12-30,9015,715,729,1444,46450
7,2020-12-31,12194,709,640,1349,47799
7,2021-01-01,984,70,174,244,48043
7,2021-01-02,1719,160,65,225,48268
7,2021-01-03,294,37,89,126,48394
7,2021-01-04,18088,1688,371,2059,50453
7,2021-01-05,12041,947,655,1602,52055
7,2021-01-06,1360,101,315,416,52471
7,2021-01-07,8008,621,268,889,53360
7,2021-01-08,10576,517,430,947,54307
7,2021-01-09,2373,125,439,564,54871
7,2021-01-10,499,23,63,86,54957
7,2021-01-11,7643,435,343,778,55735
7,2021-01-12,8469,370,455,825,56560
7,2021-01-13,5502,208,342,550,57110
7,2021-01-14,5488,238,268,506,57616
7,2021-01-15,6531,209,159,368,57984
7,2021-01-16,1659,76,72,148,58132
7,2021-01-17,15401,1008,107,1115,59247
7,2021-01-18,9764,309,203,512,59759
7,2021-01-19,11294,290,281,571,60330
7,2021-01-20,13200,169,253,422,60752
7,2021-01-21,18869,195,187,382,61134
7,2021-01-22,33716,249,187,436,61570
7,2021-01-23,90280,434,189,623,62193
7,2021-01-24,53344,386,12,398,62591
7,2021-01-25,27965,238,196,434,63025
7,2021-01-26,16101,141,252,393,63418
7,2021-01-27,9487,139,153,292,63710
7,2021-01-28,8344,137,311,448,64158
7,2021-01-29,15810,266,88,354,64512
7,2021-01-30,23988,214,142,356,64868
7,2021-01-31,1661,38,42,80,64948
7,2021-02-01,15479,276,220,496,65444
7,2021-02-02,11778,274,249,523,65967
7,2021-02-03,7764,207,251,458,66425
7,2021-02-04,12162,219,176,395,66820
7,2021-02-05,28005,243,177,420,67240
7,2021-02-06,67146,348,176,524,67764
7,2021-02-07,23442,151,21,172,67936
7,2021-02-08,36564,234,161,395,68331
7,2021-02-09,19727,344,323,667,68998
7,2021-02-10,17207,250,220,470,69468
7,2021-02-11,14242,212,218,430,69898
7,2021-02-12,36878,341,308,649,70547
7,2021-02-13,71951,373,157,530,71077
7,2021-02-14,32131,272,27,299,71376
7,2021-02-15,28520,277,211,488,71864
7,2021-02-16,17381,244,422,666,72530
7,2021-02-17,16168,235,293,528,73058
8,2020-09-03,0,0,22,22,636
8,2020-09-04,0,0,14,14,650
8,2020-09-05,0,0,10,10,660
8,2020-09-06,0,0,2,2,662
8,2020-09-07,0,0,4,4,666
8,2020-09-08,0,0,10,10,676
8,2020-09-09,0,0,37,37,713
8,2020-09-10,0,0,11,11,724
8,2020-09-11,0,0,20,20,744
8,2020-09-12,0,0,16,16,760
8,2020-09-13,0,0,3,3,763
8,2020-09-14,0,0,6,6,769
8,2020-09-15,0,0,10,10,779
8,2020-09-16,0,0,12,12,791
8,2020-09-17,0,0,22,22,813
8,2020-09-18,0,0,20,20,833
8,2020-09-19,0,0,13,13,846
8,2020-09-20,0,0,3,3,849
8,2020-09-21,0,0,5,5,854
8,2020-09-22,0,0,39,39,893
8,2020-09-23,0,0,23,23,916
8,2020-09-24,0,0,35,35,951
8,2020-09-25,0,0,72,72,1023
8,2020-09-26,0,0,53,53,1076
8,2020-09-27,0,0,21,21,1097
8,2020-09-28,0,0,19,19,1116
8,2020-09-29,0,0,75,75,1191
8,2020-09-30,0,0,95,95,1286
8,2020-10-01,0,0,69,69,1355
8,2020-10-02,0,0,57,57,1412
8,2020-10-03,0,0,105,105,1517
8,2020-10-04,0,0,45,45,1562
8,2020-10-05,0,0,39,39,1601
8,2020-10-06,0,0,70,70,1671
8,2020-10-07,0,0,158,158,1829
8,2020-10-08,0,0,102,102,1931
8,2020-10-09,0,0,188,188,2119
8,2020-10-10,0,0,70,70,2189
8,2020-10-11,0,0,121,121,2310
8,2020-10-12,0,0,74,74,2384
8,2020-10-13,83,3,179,182,2566
8,2020-10-14,8,0,211,211,2777
8,2020-10-15,24,5,177,182,2959
8,2020-10-16,19,0,206,206,3165
8,2020-10-17,0,0,142,142,3307
8,2020-10-18,0,0,158,158,3465
8,2020-10-19,10,0,64,64,3529
8,2020-10-20,15,1,181,182,3711
8,2020-10-21,86,2,129,131,3842
8,2020-10-22,546,16,349,365,4207
8,2020-10-23,339,8,315,323,4530
8,2020-10-24,128,15,313,328,4858
8,2020-10-25,81,2,154,156,5014
8,2020-10-26,216,10,56,66,5080
8,2020-10-27,460,21,386,407,5487
8,2020-10-28,318,13,224,237,5724
8,2020-10-29,996,13,333,346,6070
8,2020-10-30,2862,27,379,406,6476
8,2020-10-31,13915,105,82,187,6663
8,2020-11-01,6556,34,346,380,7043
8,2020-11-02,4419,51,111,162,7205
8,2020-11-03,1135,13,358,371,7576
8,2020-11-04,160,6,101,107,7683
8,2020-11-05,361,31,342,373,8056
8,2020-11-06,5344,34,195,229,8285
8,2020-11-07,3931,22,192,214,8499
8,2020-11-08,1306,8,78,86,8585
8,2020-11-09,385,5,129,134,8719
8,2020-11-10,552,11,190,201,8920
8,2020-11-11,600,7,301,308,9228
8,2020-11-12,749,13,192,205,9433
8,2020-11-13,693,29,207,236,9669
8,2020-11-14,532,12,234,246,9915
8,2020-11-15,345,7,15,22,9937
8,2020-11-16,555,24,114,138,10075
8,2020-11-17,91,9,152,161,10236
8,2020-11-18,459,16,122,138,10374
8,2020-11-19,1688,40,206,246,10620
8,2020-11-20,3034,45,176,221,10841
8,2020-11-21,894,36,87,123,10964
8,2020-11-22,31,3,57,60,11024
8,2020-11-23,3791,54,51,105,11129
8,2020-11-24,1935,64,196,260,11389
8,2020-11-25,1786,122,237,359,11748
8,2020-11-26,1145,55,239,294,12042
8,2020-11-27,2803,74,149,223,12265
8,2020-11-28,773,52,69,121,12386
8,2020-11-29,303,16,31,47,12433
8,2020-11-30,3816,62,171,233,12666
8,2020-12-01,2361,124,178,302,12968
8,2020-12-02,11536,655,194,849,13817
8,2020-12-03,7890,173,211,384,14201
8,2020-12-04,2762,82,224,306,14507
8,2020-12-05,1144,48,90,138,14645
8,2020-12-06,117,20,121,141,14786
8,2020-12-07,2214,103,270,373,15159
8,2020-12-08,4460,355,226,581,15740
8,2020-12-09,3952,166,279,445,16185
8,2020-12-10,4240,176,283,459,16644
8,2020-12-11,5719,258,355,613,17257
8,2020-12-12,1705,118,369,487,17744
8,2020-12-13,183,2,47,49,17793
8,2020-12-14,3132,239,256,495,18288
8,2020-12-15,5424,338,319,657,18945
8,2020-12-16,6214,316,455,771,19716
8,2020-12-17,5547,255,463,718,20434
8,2020-12-18,8810,326,310,636,21070
8,2020-12-19,1207,59,207,266,21336
8,2020-12-20,56,8,215,223,21559
8,2020-12-21,7493,509,405,914,22473
8,2020-12-22,8379,459,438,897,23370
8,2020-12-23,8296,354,304,658,24028
8,2020-12-24,1560,90,564,654,24682
8,2020-12-25,150,10,237,247,24929
8,2020-12-26,297,23,163,186,25115
8,2020-12-27,163,16,159,175,25290
8,2020-12-28,9100,804,356,1160,26450
8,2020-12-29,8178,605,419,1024,27474
8,2020-12-30,6889,412,590,1002,28476
8,2020-12-31,8338,461,625,1086,29562
8,2021-01-01,774,49,398,447,30009
8,2021-01-02,492,52,88,140,30149
8,2021-01-03,683,22,118,140,30289
8,2021-01-04,7512,690,407,1097,31386
8,2021-01-05,8106,515,584,1099,32485
8,2021-01-06,462,33,442,475,32960
8,2021-01-07,6540,404,251,655,33615
8,2021-01-08,8321,377,551,928,34543
8,2021-01-09,1179,45,469,514,35057
8,2021-01-10,140,6,193,199,35256
8,2021-01-11,8065,295,309,604,35860
8,2021-01-12,6802,247,482,729,36589
8,2021-01-13,4999,218,421,639,37228
8,2021-01-14,5544,213,358,571,37799
8,2021-01-15,6481,210,308,518,38317
8,2021-01-16,1450,47,153,200,38517
8,2021-01-17,549,14,155,169,38686
8,2021-01-18,5611,203,333,536,39222
8,2021-01-19,11098,194,248,442,39664
8,2021-01-20,10715,194,374,568,40232
8,2021-01-21,13803,159,274,433,40665
8,2021-01-22,19936,262,316,578,41243
8,2021-01-23,82859,843,232,1075,42318
8,2021-01-24,45045,592,150,742,43060
8,2021-01-25,27653,446,226,672,43732
8,2021-01-26,14149,240,530,770,44502
8,2021-01-27,7440,195,265,460,44962
8,2021-01-28,9066,233,540,773,45735
8,2021-01-29,37264,450,258,708,46443
8,2021-01-30,77658,673,320,993,47436
8,2021-01-31,54259,585,142,727,48163
8,2021-02-01,20355,341,415,756,48919
8,2021-02-02,23710,429,473,902,49821
8,2021-02-03,33460,1101,296,1397,51218
8,2021-02-04,14470,358,391,749,51967
8,2021-02-05,42196,487,384,871,52838
8,2021-02-06,101446,858,318,1176,54014
8,2021-02-07,56952,605,208,813,54827
8,2021-02-08,28798,433,237,670,55497
8,2021-02-09,23962,442,545,987,56484
8,2021-02-10,20360,434,360,794,57278
8,2021-02-11,14389,320,435,755,58033
8,2021-02-12,49407,590,448,1038,59071
8,2021-02-13,91042,734,206,940,60011
8,2021-02-14,57035,517,241,758,60769
8,2021-02-15,24456,349,216,565,61334
8,2021-02-16,21677,448,600,1048,62382
8,2021-02-17,17596,423,322,745,63127
