1,1,2020-09-03,2020-09-03,0,0,0,0,51,51,51,51,1461,1461
1,1,2020-09-04,2020-09-04,0,0,0,0,87,87,87,87,1548,1548
1,1,2020-09-05,2020-09-05,0,0,0,0,37,37,37,37,1585,1585
1,1,2020-09-06,2020-09-06,0,0,0,0,11,11,11,11,1596,1596
1,1,2020-09-07,2020-09-07,0,0,0,0,39,39,39,39,1635,1635
1,1,2020-09-08,2020-09-08,0,0,0,0,58,58,58,58,1693,1693
1,1,2020-09-09,2020-09-09,0,0,0,0,40,40,40,40,1733,1733
1,1,2020-09-10,2020-09-10,0,0,0,0,47,47,47,47,1780,1780
1,1,2020-09-11,2020-09-11,0,0,0,0,50,50,50,50,1830,1830
1,1,2020-09-12,2020-09-12,0,0,0,0,24,24,24,24,1854,1854
1,1,2020-09-13,2020-09-13,0,0,0,0,11,11,11,11,1865,1865
1,1,2020-09-14,2020-09-14,0,0,0,0,24,24,24,24,1889,1889
1,1,2020-09-15,2020-09-15,0,0,0,0,26,26,26,26,1915,1915
1,1,2020-09-16,2020-09-16,0,0,0,0,32,32,32,32,1947,1947
1,1,2020-09-17,2020-09-17,0,0,0,0,52,52,52,52,1999,1999
1,1,2020-09-18,2020-09-18,0,0,0,0,42,42,42,42,2041,2041
1,1,2020-09-19,2020-09-19,0,0,0,0,59,59,59,59,2100,2100
1,1,2020-09-20,2020-09-20,0,0,0,0,25,25,25,25,2125,2125
1,1,2020-09-21,2020-09-21,0,0,0,0,32,32,32,32,2157,2157
1,1,2020-09-22,2020-09-22,0,0,0,0,81,81,81,81,2238,2238
1,1,2020-09-23,2020-09-23,0,0,0,0,55,55,55,55,2293,2293
1,1,2020-09-24,2020-09-24,0,0,0,0,73,73,73,73,2366,2366
1,1,2020-09-25,2020-09-25,0,0,0,0,97,97,97,97,2463,2463
1,1,2020-09-26,2020-09-26,0,0,0,0,86,86,86,86,2549,2549
1,1,2020-09-27,2020-09-27,0,0,0,0,48,48,48,48,2597,2597
1,1,2020-09-28,2020-09-28,0,0,0,0,29,29,29,29,2626,2626
1,1,2020-09-29,2020-09-29,0,0,0,0,74,74,74,74,2700,2700
1,1,2020-09-30,2020-09-30,0,0,0,0,91,91,91,91,2791,2791
1,1,2020-10-01,2020-10-01,0,0,0,0,72,72,72,72,2863,2863
1,1,2020-10-02,2020-10-02,0,0,0,0,101,101,101,101,2964,2964
1,1,2020-10-03,2020-10-03,0,0,0,0,82,82,82,82,3046,3046
1,1,2020-10-04,2020-10-04,0,0,0,0,49,49,49,49,3095,3095
1,1,2020-10-05,2020-10-05,0,0,0,0,30,30,30,30,3125,3125
1,1,2020-10-06,2020-10-06,0,0,0,0,108,108,108,108,3233,3233
1,1,2020-10-07,2020-10-07,0,0,0,0,107,107,107,107,3340,3340
1,1,2020-10-08,2020-10-08,0,0,0,0,100,100,100,100,3440,3440
1,1,2020-10-09,2020-10-09,0,0,0,0,148,148,148,148,3588,3588
1,1,2020-10-10,2020-10-10,0,0,0,0,55,55,55,55,3643,3643
1,1,2020-10-11,2020-10-11,0,0,0,0,80,80,80,80,3723,3723
1,1,2020-10-12,2020-10-12,0,0,0,0,46,46,46,46,3769,3769
1,1,2020-10-13,2020-10-13,116,116,8,8,86,86,94,94,3863,3863
1,1,2020-10-14,2020-10-14,4,4,0,0,127,127,127,127,3990,3990
1,1,2020-10-15,2020-10-15,7,7,1,1,135,135,136,136,4126,4126
1,1,2020-10-16,2020-10-16,15,15,1,1,103,103,104,104,4230,4230
1,1,2020-10-17,2020-10-17,0,0,0,0,136,136,136,136,4366,4366
1,1,2020-10-18,2020-10-18,92,92,0,0,75,75,75,75,4441,4441
1,1,2020-10-19,2020-10-19,83,83,3,3,148,148,151,151,4592,4592
1,1,2020-10-20,2020-10-20,101,101,4,4,183,183,187,187,4779,4779
1,1,2020-10-21,2020-10-21,96,96,6,6,66,66,72,72,4851,4851
1,1,2020-10-22,2020-10-22,219,219,15,15,192,192,207,207,5058,5058
1,1,2020-10-23,2020-10-23,152,152,8,8,151,151,159,159,5217,5217
1,1,2020-10-24,2020-10-24,227,227,6,6,170,170,176,176,5393,5393
1,1,2020-10-25,2020-10-25,35,35,2,2,152,152,154,154,5547,5547
1,1,2020-10-26,2020-10-26,240,240,11,11,123,123,134,134,5681,5681
1,1,2020-10-27,2020-10-27,149,149,4,4,256,256,260,260,5941,5941
1,1,2020-10-28,2020-10-28,275,275,15,15,220,220,235,235,6176,6176
1,1,2020-10-29,2020-10-29,120,120,4,4,262,262,266,266,6442,6442
1,1,2020-10-30,2020-10-30,17488,17488,138,138,158,158,296,296,6738,6738
1,1,2020-10-31,2020-10-31,22530,22530,123,123,173,173,296,296,7034,7034
1,1,2020-11-01,2020-11-01,8733,8733,39,39,227,227,266,266,7300,7300
1,1,2020-11-02,2020-11-02,3387,3387,22,22,202,202,224,224,7524,7524
1,1,2020-11-03,2020-11-03,949,949,5,5,251,251,256,256,7780,7780
1,1,2020-11-04,2020-11-04,421,421,10,10,65,65,75,75,7855,7855
1,1,2020-11-05,2020-11-05,487,487,11,11,175,175,186,186,8041,8041
1,1,2020-11-06,2020-11-06,6466,6466,25,25,281,281,306,306,8347,8347
1,1,2020-11-07,2020-11-07,4056,4056,17,17,88,88,105,105,8452,8452
1,1,2020-11-08,2020-11-08,875,875,6,6,82,82,88,88,8540,8540
1,1,2020-11-09,2020-11-09,467,467,1,1,70,70,71,71,8611,8611
1,1,2020-11-10,2020-11-10,819,819,14,14,136,136,150,150,8761,8761
1,1,2020-11-11,2020-11-11,1441,1441,12,12,159,159,171,171,8932,8932
1,1,2020-11-12,2020-11-12,1733,1733,6,6,141,141,147,147,9079,9079
1,1,2020-11-13,2020-11-13,2117,2117,21,21,94,94,115,115,9194,9194
1,1,2020-11-14,2020-11-14,1849,1849,15,15,53,53,68,68,9262,9262
1,1,2020-11-15,2020-11-15,236,236,0,0,47,47,47,47,9309,9309
1,1,2020-11-16,2020-11-16,660,660,9,9,82,82,91,91,9400,9400
1,1,2020-11-17,2020-11-17,951,951,23,23,108,108,131,131,9531,9531
1,1,2020-11-18,2020-11-18,691,691,75,75,118,118,193,193,9724,9724
1,1,2020-11-19,2020-11-19,1016,1016,29,29,173,173,202,202,9926,9926
1,1,2020-11-20,2020-11-20,2917,2917,48,48,118,118,166,166,10092,10092
1,1,2020-11-21,2020-11-21,2173,2173,47,47,109,109,156,156,10248,10248
1,1,2020-11-22,2020-11-22,88,88,7,7,36,36,43,43,10291,10291
1,1,2020-11-23,2020-11-23,418,418,13,13,67,67,80,80,10371,10371
1,1,2020-11-24,2020-11-24,3055,3055,67,67,81,81,148,148,10519,10519
1,1,2020-11-25,2020-11-25,1164,1164,31,31,140,140,171,171,10690,10690
1,1,2020-11-26,2020-11-26,1139,1139,25,25,129,129,154,154,10844,10844
1,1,2020-11-27,2020-11-27,1227,1227,29,29,54,54,83,83,10927,10927
1,1,2020-11-28,2020-11-28,2004,2004,21,21,232,232,253,253,11180,11180
1,1,2020-11-29,2020-11-29,62,62,21,21,52,52,73,73,11253,11253
1,1,2020-11-30,2020-11-30,2184,2184,123,123,152,152,275,275,11528,11528
1,1,2020-12-01,2020-12-01,3473,3473,168,168,255,255,423,423,11951,11951
1,1,2020-12-02,2020-12-02,2587,2587,83,83,204,204,287,287,12238,12238
1,1,2020-12-03,2020-12-03,5138,5138,102,102,213,213,315,315,12553,12553
1,1,2020-12-04,2020-12-04,4615,4615,104,104,200,200,304,304,12857,12857
1,1,2020-12-05,2020-12-05,2174,2174,40,40,266,266,306,306,13163,13163
1,1,2020-12-06,2020-12-06,1636,1636,52,52,61,61,113,113,13276,13276
1,1,2020-12-07,2020-12-07,4513,4513,168,168,272,272,440,440,13716,13716
1,1,2020-12-08,2020-12-08,6113,6113,213,213,234,234,447,447,14163,14163
1,1,2020-12-09,2020-12-09,4966,4966,188,188,382,382,570,570,14733,14733
1,1,2020-12-10,2020-12-10,5310,5310,222,222,286,286,508,508,15241,15241
1,1,2020-12-11,2020-12-11,7269,7269,302,302,326,326,628,628,15869,15869
1,1,2020-12-12,2020-12-12,3891,3891,157,157,361,361,518,518,16387,16387
1,1,2020-12-13,2020-12-13,115,115,7,7,125,125,132,132,16519,16519
1,1,2020-12-14,2020-12-14,6855,6855,306,306,279,279,585,585,17104,17104
1,1,2020-12-15,2020-12-15,11170,11170,488,488,423,423,911,911,18015,18015
1,1,2020-12-16,2020-12-16,10864,10864,456,456,282,282,738,738,18753,18753
1,1,2020-12-17,2020-12-17,10367,10367,403,403,502,502,905,905,19658,19658
1,1,2020-12-18,2020-12-18,10890,10890,413,413,306,306,719,719,20377,20377
1,1,2020-12-19,2020-12-19,3279,3279,129,129,396,396,525,525,20902,20902
1,1,2020-12-20,2020-12-20,688,688,54,54,180,180,234,234,21136,21136
1,1,2020-12-21,2020-12-21,16753,16753,1998,1998,392,392,2390,2390,23526,23526
1,1,2020-12-22,2020-12-22,15702,15702,762,762,327,327,1089,1089,24615,24615
1,1,2020-12-23,2020-12-23,13305,13305,491,491,416,416,907,907,25522,25522
1,1,2020-12-24,2020-12-24,3475,3475,102,102,536,536,638,638,26160,26160
1,1,2020-12-25,2020-12-25,498,498,38,38,114,114,152,152,26312,26312
1,1,2020-12-26,2020-12-26,439,439,23,23,75,75,98,98,26410,26410
1,1,2020-12-27,2020-12-27,722,722,76,76,160,160,236,236,26646,26646
1,1,2020-12-28,2020-12-28,8167,8167,559,559,255,255,814,814,27460,27460
1,1,2020-12-29,2020-12-29,10881,10881,772,772,303,303,1075,1075,28535,28535
1,1,2020-12-30,2020-12-30,9714,9714,519,519,650,650,1169,1169,29704,29704
1,1,2020-12-31,2020-12-31,14414,14414,590,590,925,925,1515,1515,31219,31219
1,1,2021-01-01,2021-01-01,3273,3273,130,130,235,235,365,365,31584,31584
1,1,2021-01-02,2021-01-02,426,426,56,56,185,185,241,241,31825,31825
1,1,2021-01-03,2021-01-03,430,430,41,41,77,77,118,118,31943,31943
1,1,2021-01-04,2021-01-04,7740,7740,598,598,601,601,1199,1199,33142,33142
1,1,2021-01-05,2021-01-05,12199,12199,832,832,619,619,1451,1451,34593,34593
1,1,2021-01-06,2021-01-06,3234,3234,216,216,271,271,487,487,35080,35080
1,1,2021-01-07,2021-01-07,7253,7253,398,398,537,537,935,935,36015,36015
1,1,2021-01-08,2021-01-08,9258,9258,425,425,556,556,981,981,36996,36996
1,1,2021-01-09,2021-01-09,5237,5237,291,291,351,351,642,642,37638,37638
1,1,2021-01-10,2021-01-10,1420,1420,79,79,252,252,331,331,37969,37969
1,1,2021-01-11,2021-01-11,19204,19204,376,376,397,397,773,773,38742,38742
1,1,2021-01-12,2021-01-12,9898,9898,463,463,450,450,913,913,39655,39655
1,1,2021-01-13,2021-01-13,8214,8214,328,328,336,336,664,664,40319,40319
1,1,2021-01-14,2021-01-14,8351,8351,273,273,363,363,636,636,40955,40955
1,1,2021-01-15,2021-01-15,7886,7886,254,254,251,251,505,505,41460,41460
1,1,2021-01-16,2021-01-16,2905,2905,156,156,70,70,226,226,41686,41686
1,1,2021-01-17,2021-01-17,436,436,26,26,244,244,270,270,41956,41956
1,1,2021-01-18,2021-01-18,12351,12351,706,706,357,357,1063,1063,43019,43019
1,1,2021-01-19,2021-01-19,13680,13680,328,328,375,375,703,703,43722,43722
1,1,2021-01-20,2021-01-20,27175,27175,453,453,360,360,813,813,44535,44535
1,1,2021-01-21,2021-01-21,105022,105022,1292,1292,255,255,1547,1547,46082,46082
1,1,2021-01-22,2021-01-22,39582,39582,341,341,199,199,540,540,46622,46622
1,1,2021-01-23,2021-01-23,74071,74071,636,636,396,396,1032,1032,47654,47654
1,1,2021-01-24,2021-01-24,34243,34243,342,342,175,175,517,517,48171,48171
1,1,2021-01-25,2021-01-25,22181,22181,230,230,356,356,586,586,48757,48757
1,1,2021-01-26,2021-01-26,22104,22104,279,279,297,297,576,576,49333,49333
1,1,2021-01-27,2021-01-27,23049,23049,348,348,336,336,684,684,50017,50017
1,1,2021-01-28,2021-01-28,10437,10437,289,289,307,307,596,596,50613,50613
1,1,2021-01-29,2021-01-29,14885,14885,323,323,82,82,405,405,51018,51018
1,1,2021-01-30,2021-01-30,38187,38187,413,413,310,310,723,723,51741,51741
1,1,2021-01-31,2021-01-31,33122,33122,375,375,180,180,555,555,52296,52296
1,1,2021-02-01,2021-02-01,37433,37433,442,442,221,221,663,663,52959,52959
1,1,2021-02-02,2021-02-02,26715,26715,407,407,397,397,804,804,53763,53763
1,1,2021-02-03,2021-02-03,11837,11837,302,302,161,161,463,463,54226,54226
1,1,2021-02-04,2021-02-04,14675,14675,320,320,555,555,875,875,55101,55101
1,1,2021-02-05,2021-02-05,24124,24124,345,345,327,327,672,672,55773,55773
1,1,2021-02-06,2021-02-06,58933,58933,478,478,116,116,594,594,56367,56367
1,1,2021-02-07,2021-02-07,46664,46664,383,383,243,243,626,626,56993,56993
1,1,2021-02-08,2021-02-08,31244,31244,359,359,484,484,843,843,57836,57836
1,1,2021-02-09,2021-02-09,32101,32101,392,392,287,287,679,679,58515,58515
1,1,2021-02-10,2021-02-10,19578,19578,305,305,314,314,619,619,59134,59134
1,1,2021-02-11,2021-02-11,21157,21157,247,247,337,337,584,584,59718,59718
1,1,2021-02-12,2021-02-12,29447,29447,252,252,282,282,534,534,60252,60252
1,1,2021-02-13,2021-02-13,53485,53485,418,418,173,173,591,591,60843,60843
1,1,2021-02-14,2021-02-14,36069,36069,241,241,153,153,394,394,61237,61237
1,1,2021-02-15,2021-02-15,31930,31930,322,322,248,248,570,570,61807,61807
1,1,2021-02-16,2021-02-16,21960,21960,252,252,289,289,541,541,62348,62348
1,1,2021-02-17,2021-02-17,18574,18574,251,251,264,264,515,515,62863,62863
2,2,2020-09-03,2020-09-03,0,0,0,0,8,8,8,8,594,594
2,2,2020-09-04,2020-09-04,0,0,0,0,16,16,16,16,610,610
2,2,2020-09-05,2020-09-05,0,0,0,0,7,7,7,7,617,617
2,2,2020-09-06,2020-09-06,0,0,0,0,5,5,5,5,622,622
2,2,2020-09-07,2020-09-07,0,0,0,0,7,7,7,7,629,629
2,2,2020-09-08,2020-09-08,0,0,0,0,11,11,11,11,640,640
2,2,2020-09-09,2020-09-09,0,0,0,0,14,14,14,14,654,654
2,2,2020-09-10,2020-09-10,0,0,0,0,32,32,32,32,686,686
2,2,2020-09-11,2020-09-11,0,0,0,0,16,16,16,16,702,702
2,2,2020-09-12,2020-09-12,0,0,0,0,12,12,12,12,714,714
2,2,2020-09-13,2020-09-13,0,0,0,0,9,9,9,9,723,723
2,2,2020-09-14,2020-09-14,0,0,0,0,26,26,26,26,749,749
2,2,2020-09-15,2020-09-15,0,0,0,0,5,5,5,5,754,754
2,2,2020-09-16,2020-09-16,0,0,0,0,49,49,49,49,803,803
2,2,2020-09-17,2020-09-17,0,0,0,0,42,42,42,42,845,845
2,2,2020-09-18,2020-09-18,0,0,0,0,33,33,33,33,878,878
2,2,2020-09-19,2020-09-19,0,0,0,0,4,4,4,4,882,882
2,2,2020-09-20,2020-09-20,0,0,0,0,17,17,17,17,899,899
2,2,2020-09-21,2020-09-21,0,0,0,0,41,41,41,41,940,940
2,2,2020-09-22,2020-09-22,0,0,0,0,55,55,55,55,995,995
2,2,2020-09-23,2020-09-23,0,0,0,0,43,43,43,43,1038,1038
2,2,2020-09-24,2020-09-24,0,0,0,0,42,42,42,42,1080,1080
2,2,2020-09-25,2020-09-25,0,0,0,0,32,32,32,32,1112,1112
2,2,2020-09-26,2020-09-26,0,0,0,0,46,46,46,46,1158,1158
2,2,2020-09-27,2020-09-27,0,0,0,0,30,30,30,30,1188,1188
2,2,2020-09-28,2020-09-28,0,0,0,0,69,69,69,69,1257,1257
2,2,2020-09-29,2020-09-29,0,0,0,0,40,40,40,40,1297,1297
2,2,2020-09-30,2020-09-30,0,0,0,0,91,91,91,91,1388,1388
2,2,2020-10-01,2020-10-01,0,0,0,0,53,53,53,53,1441,1441
2,2,2020-10-02,2020-10-02,0,0,0,0,41,41,41,41,1482,1482
2,2,2020-10-03,2020-10-03,0,0,0,0,60,60,60,60,1542,1542
2,2,2020-10-04,2020-10-04,0,0,0,0,44,44,44,44,1586,1586
2,2,2020-10-05,2020-10-05,0,0,0,0,33,33,33,33,1619,1619
2,2,2020-10-06,2020-10-06,0,0,0,0,112,112,112,112,1731,1731
2,2,2020-10-07,2020-10-07,0,0,0,0,80,80,80,80,1811,1811
2,2,2020-10-08,2020-10-08,0,0,0,0,153,153,153,153,1964,1964
2,2,2020-10-09,2020-10-09,0,0,0,0,156,156,156,156,2120,2120
2,2,2020-10-10,2020-10-10,0,0,0,0,128,128,128,128,2248,2248
2,2,2020-10-11,2020-10-11,0,0,0,0,31,31,31,31,2279,2279
2,2,2020-10-12,2020-10-12,42,42,1,1,33,33,34,34,2313,2313
2,2,2020-10-13,2020-10-13,18,18,2,2,138,138,140,140,2453,2453
2,2,2020-10-14,2020-10-14,471,471,3,3,236,236,239,239,2692,2692
2,2,2020-10-15,2020-10-15,68,68,2,2,155,155,157,157,2849,2849
2,2,2020-10-16,2020-10-16,47,47,2,2,86,86,88,88,2937,2937
2,2,2020-10-17,2020-10-17,0,0,0,0,123,123,123,123,3060,3060
2,2,2020-10-18,2020-10-18,0,0,0,0,84,84,84,84,3144,3144
2,2,2020-10-19,2020-10-19,55,55,0,0,67,67,67,67,3211,3211
2,2,2020-10-20,2020-10-20,85,85,3,3,202,202,205,205,3416,3416
2,2,2020-10-21,2020-10-21,76,76,3,3,134,134,137,137,3553,3553
2,2,2020-10-22,2020-10-22,57,57,2,2,195,195,197,197,3750,3750
2,2,2020-10-23,2020-10-23,93,93,4,4,201,201,205,205,3955,3955
2,2,2020-10-24,2020-10-24,111,111,2,2,158,158,160,160,4115,4115
2,2,2020-10-25,2020-10-25,20,20,1,1,95,95,96,96,4211,4211
2,2,2020-10-26,2020-10-26,31,31,2,2,153,153,155,155,4366,4366
2,2,2020-10-27,2020-10-27,497,497,36,36,199,199,235,235,4601,4601
2,2,2020-10-28,2020-10-28,133,133,16,16,319,319,335,335,4936,4936
2,2,2020-10-29,2020-10-29,1477,1477,16,16,273,273,289,289,5225,5225
2,2,2020-10-30,2020-10-30,3811,3811,27,27,198,198,225,225,5450,5450
2,2,2020-10-31,2020-10-31,5065,5065,41,41,259,259,300,300,5750,5750
2,2,2020-11-01,2020-11-01,521,521,27,27,87,87,114,114,5864,5864
2,2,2020-11-02,2020-11-02,1759,1759,31,31,281,281,312,312,6176,6176
2,2,2020-11-03,2020-11-03,135,135,8,8,317,317,325,325,6501,6501
2,2,2020-11-04,2020-11-04,222,222,10,10,188,188,198,198,6699,6699
2,2,2020-11-05,2020-11-05,247,247,27,27,150,150,177,177,6876,6876
2,2,2020-11-06,2020-11-06,1550,1550,19,19,260,260,279,279,7155,7155
2,2,2020-11-07,2020-11-07,6144,6144,74,74,207,207,281,281,7436,7436
2,2,2020-11-08,2020-11-08,310,310,4,4,55,55,59,59,7495,7495
2,2,2020-11-09,2020-11-09,392,392,23,23,196,196,219,219,7714,7714
2,2,2020-11-10,2020-11-10,919,919,30,30,189,189,219,219,7933,7933
2,2,2020-11-11,2020-11-11,407,407,15,15,257,257,272,272,8205,8205
2,2,2020-11-12,2020-11-12,438,438,18,18,162,162,180,180,8385,8385
2,2,2020-11-13,2020-11-13,1333,1333,21,21,219,219,240,240,8625,8625
2,2,2020-11-14,2020-11-14,399,399,10,10,86,86,96,96,8721,8721
2,2,2020-11-15,2020-11-15,77,77,4,4,23,23,27,27,8748,8748
2,2,2020-11-16,2020-11-16,714,714,32,32,187,187,219,219,8967,8967
2,2,2020-11-17,2020-11-17,767,767,72,72,129,129,201,201,9168,9168
2,2,2020-11-18,2020-11-18,791,791,75,75,235,235,310,310,9478,9478
2,2,2020-11-19,2020-11-19,752,752,58,58,157,157,215,215,9693,9693
2,2,2020-11-20,2020-11-20,1088,1088,61,61,246,246,307,307,10000,10000
2,2,2020-11-21,2020-11-21,1237,1237,23,23,129,129,152,152,10152,10152
2,2,2020-11-22,2020-11-22,57,57,3,3,10,10,13,13,10165,10165
2,2,2020-11-23,2020-11-23,7332,7332,125,125,242,242,367,367,10532,10532
2,2,2020-11-24,2020-11-24,1863,1863,91,91,295,295,386,386,10918,10918
2,2,2020-11-25,2020-11-25,1101,1101,72,72,232,232,304,304,11222,11222
2,2,2020-11-26,2020-11-26,1044,1044,59,59,234,234,293,293,11515,11515
2,2,2020-11-27,2020-11-27,1674,1674,83,83,148,148,231,231,11746,11746
2,2,2020-11-28,2020-11-28,1530,1530,77,77,83,83,160,160,11906,11906
2,2,2020-11-29,2020-11-29,742,742,34,34,17,17,51,51,11957,11957
2,2,2020-11-30,2020-11-30,7546,7546,186,186,200,200,386,386,12343,12343
2,2,2020-12-01,2020-12-01,3395,3395,205,205,253,253,458,458,12801,12801
2,2,2020-12-02,2020-12-02,4692,4692,176,176,284,284,460,460,13261,13261
2,2,2020-12-03,2020-12-03,2960,2960,190,190,248,248,438,438,13699,13699
2,2,2020-12-04,2020-12-04,4106,4106,158,158,242,242,400,400,14099,14099
2,2,2020-12-05,2020-12-05,2259,2259,41,41,129,129,170,170,14269,14269
2,2,2020-12-06,2020-12-06,0,0,0,0,46,46,46,46,14315,14315
2,2,2020-12-07,2020-12-07,3094,3094,199,199,178,178,377,377,14692,14692
2,2,2020-12-08,2020-12-08,4394,4394,304,304,281,281,585,585,15277,15277
2,2,2020-12-09,2020-12-09,4604,4604,321,321,521,521,842,842,16119,16119
2,2,2020-12-10,2020-12-10,5514,5514,320,320,183,183,503,503,16622,16622
2,2,2020-12-11,2020-12-11,4945,4945,262,262,384,384,646,646,17268,17268
2,2,2020-12-12,2020-12-12,1570,1570,114,114,254,254,368,368,17636,17636
2,2,2020-12-13,2020-12-13,0,0,0,0,7,7,7,7,17643,17643
2,2,2020-12-14,2020-12-14,3797,3797,292,292,161,161,453,453,18096,18096
2,2,2020-12-15,2020-12-15,7254,7254,632,632,492,492,1124,1124,19220,19220
2,2,2020-12-16,2020-12-16,5654,5654,405,405,312,312,717,717,19937,19937
2,2,2020-12-17,2020-12-17,5403,5403,407,407,375,375,782,782,20719,20719
2,2,2020-12-18,2020-12-18,5269,5269,378,378,341,341,719,719,21438,21438
2,2,2020-12-19,2020-12-19,1132,1132,86,86,201,201,287,287,21725,21725
2,2,2020-12-20,2020-12-20,122,122,12,12,134,134,146,146,21871,21871
2,2,2020-12-21,2020-12-21,4926,4926,399,399,328,328,727,727,22598,22598
2,2,2020-12-22,2020-12-22,6081,6081,491,491,311,311,802,802,23400,23400
2,2,2020-12-23,2020-12-23,6792,6792,375,375,210,210,585,585,23985,23985
2,2,2020-12-24,2020-12-24,1476,1476,117,117,333,333,450,450,24435,24435
2,2,2020-12-25,2020-12-25,54,54,5,5,65,65,70,70,24505,24505
2,2,2020-12-26,2020-12-26,45,45,1,1,148,148,149,149,24654,24654
2,2,2020-12-27,2020-12-27,17,17,4,4,27,27,31,31,24685,24685
2,2,2020-12-28,2020-12-28,5932,5932,612,612,213,213,825,825,25510,25510
2,2,2020-12-29,2020-12-29,5592,5592,593,593,322,322,915,915,26425,26425
2,2,2020-12-30,2020-12-30,5933,5933,612,612,785,785,1397,1397,27822,27822
2,2,2020-12-31,2020-12-31,9346,9346,858,858,498,498,1356,1356,29178,29178
2,2,2021-01-01,2021-01-01,525,525,76,76,143,143,219,219,29397,29397
2,2,2021-01-02,2021-01-02,442,442,30,30,282,282,312,312,29709,29709
2,2,2021-01-03,2021-01-03,58,58,7,7,60,60,67,67,29776,29776
2,2,2021-01-04,2021-01-04,5924,5924,689,689,302,302,991,991,30767,30767
2,2,2021-01-05,2021-01-05,6893,6893,705,705,611,611,1316,1316,32083,32083
2,2,2021-01-06,2021-01-06,890,890,132,132,179,179,311,311,32394,32394
2,2,2021-01-07,2021-01-07,4471,4471,397,397,501,501,898,898,33292,33292
2,2,2021-01-08,2021-01-08,6851,6851,502,502,381,381,883,883,34175,34175
2,2,2021-01-09,2021-01-09,1875,1875,100,100,417,417,517,517,34692,34692
2,2,2021-01-10,2021-01-10,8,8,0,0,71,71,71,71,34763,34763
2,2,2021-01-11,2021-01-11,5287,5287,376,376,370,370,746,746,35509,35509
2,2,2021-01-12,2021-01-12,7660,7660,483,483,469,469,952,952,36461,36461
2,2,2021-01-13,2021-01-13,5130,5130,378,378,457,457,835,835,37296,37296
2,2,2021-01-14,2021-01-14,4331,4331,337,337,452,452,789,789,38085,38085
2,2,2021-01-15,2021-01-15,5802,5802,336,336,278,278,614,614,38699,38699
2,2,2021-01-16,2021-01-16,618,618,19,19,103,103,122,122,38821,38821
2,2,2021-01-17,2021-01-17,1069,1069,215,215,128,128,343,343,39164,39164
2,2,2021-01-18,2021-01-18,6721,6721,484,484,247,247,731,731,39895,39895
2,2,2021-01-19,2021-01-19,7367,7367,347,347,415,415,762,762,40657,40657
2,2,2021-01-20,2021-01-20,8423,8423,274,274,503,503,777,777,41434,41434
2,2,2021-01-21,2021-01-21,14212,14212,378,378,311,311,689,689,42123,42123
2,2,2021-01-22,2021-01-22,32939,32939,500,500,217,217,717,717,42840,42840
2,2,2021-01-23,2021-01-23,118232,118232,1336,1336,372,372,1708,1708,44548,44548
2,2,2021-01-24,2021-01-24,56355,56355,703,703,91,91,794,794,45342,45342
2,2,2021-01-25,2021-01-25,44073,44073,632,632,210,210,842,842,46184,46184
2,2,2021-01-26,2021-01-26,25995,25995,650,650,565,565,1215,1215,47399,47399
2,2,2021-01-27,2021-01-27,5520,5520,219,219,433,433,652,652,48051,48051
2,2,2021-01-28,2021-01-28,6101,6101,286,286,389,389,675,675,48726,48726
2,2,2021-01-29,2021-01-29,9848,9848,284,284,196,196,480,480,49206,49206
2,2,2021-01-30,2021-01-30,111734,111734,1279,1279,323,323,1602,1602,50808,50808
2,2,2021-01-31,2021-01-31,63506,63506,778,778,19,19,797,797,51605,51605
2,2,2021-02-01,2021-02-01,40502,40502,710,710,198,198,908,908,52513,52513
2,2,2021-02-02,2021-02-02,14246,14246,415,415,446,446,861,861,53374,53374
2,2,2021-02-03,2021-02-03,6519,6519,390,390,472,472,862,862,54236,54236
2,2,2021-02-04,2021-02-04,11242,11242,551,551,456,456,1007,1007,55243,55243
2,2,2021-02-05,2021-02-05,16272,16272,354,354,377,377,731,731,55974,55974
2,2,2021-02-06,2021-02-06,113372,113372,1473,1473,348,348,1821,1821,57795,57795
2,2,2021-02-07,2021-02-07,69464,69464,627,627,140,140,767,767,58562,58562
2,2,2021-02-08,2021-02-08,34326,34326,486,486,220,220,706,706,59268,59268
2,2,2021-02-09,2021-02-09,13114,13114,366,366,544,544,910,910,60178,60178
2,2,2021-02-10,2021-02-10,9097,9097,298,298,511,511,809,809,60987,60987
2,2,2021-02-11,2021-02-11,9993,9993,345,345,422,422,767,767,61754,61754
2,2,2021-02-12,2021-02-12,23371,23371,315,315,300,300,615,615,62369,62369
2,2,2021-02-13,2021-02-13,135650,135650,967,967,218,218,1185,1185,63554,63554
2,2,2021-02-14,2021-02-14,45191,45191,343,343,51,51,394,394,63948,63948
2,2,2021-02-15,2021-02-15,16462,16462,214,214,146,146,360,360,64308,64308
2,2,2021-02-16,2021-02-16,10762,10762,253,253,426,426,679,679,64987,64987
2,2,2021-02-17,2021-02-17,7713,7713,338,338,431,431,769,769,65756,65756
3,3,2020-09-03,2020-09-03,0,0,0,0,10,10,10,10,762,762
3,3,2020-09-04,2020-09-04,0,0,0,0,9,9,9,9,771,771
3,3,2020-09-05,2020-09-05,0,0,0,0,3,3,3,3,774,774
3,3,2020-09-06,2020-09-06,0,0,0,0,1,1,1,1,775,775
3,3,2020-09-07,2020-09-07,0,0,0,0,6,6,6,6,781,781
3,3,2020-09-08,2020-09-08,0,0,0,0,12,12,12,12,793,793
3,3,2020-09-09,2020-09-09,0,0,0,0,11,11,11,11,804,804
3,3,2020-09-10,2020-09-10,0,0,0,0,15,15,15,15,819,819
3,3,2020-09-11,2020-09-11,0,0,0,0,27,27,27,27,846,846
3,3,2020-09-12,2020-09-12,0,0,0,0,2,2,2,2,848,848
3,3,2020-09-13,2020-09-13,0,0,0,0,12,12,12,12,860,860
3,3,2020-09-14,2020-09-14,0,0,0,0,5,5,5,5,865,865
3,3,2020-09-15,2020-09-15,0,0,0,0,8,8,8,8,873,873
3,3,2020-09-16,2020-09-16,0,0,0,0,14,14,14,14,887,887
3,3,2020-09-17,2020-09-17,0,0,0,0,20,20,20,20,907,907
3,3,2020-09-18,2020-09-18,0,0,0,0,41,41,41,41,948,948
3,3,2020-09-19,2020-09-19,0,0,0,0,20,20,20,20,968,968
3,3,2020-09-20,2020-09-20,0,0,0,0,21,21,21,21,989,989
3,3,2020-09-21,2020-09-21,0,0,0,0,23,23,23,23,1012,1012
3,3,2020-09-22,2020-09-22,0,0,0,0,26,26,26,26,1038,1038
3,3,2020-09-23,2020-09-23,0,0,0,0,32,32,32,32,1070,1070
3,3,2020-09-24,2020-09-24,0,0,0,0,41,41,41,41,1111,1111
3,3,2020-09-25,2020-09-25,0,0,0,0,72,72,72,72,1183,1183
3,3,2020-09-26,2020-09-26,0,0,0,0,37,37,37,37,1220,1220
3,3,2020-09-27,2020-09-27,0,0,0,0,12,12,12,12,1232,1232
3,3,2020-09-28,2020-09-28,0,0,0,0,7,7,7,7,1239,1239
3,3,2020-09-29,2020-09-29,0,0,0,0,43,43,43,43,1282,1282
3,3,2020-09-30,2020-09-30,0,0,0,0,76,76,76,76,1358,1358
3,3,2020-10-01,2020-10-01,0,0,0,0,58,58,58,58,1416,1416
3,3,2020-10-02,2020-10-02,0,0,0,0,69,69,69,69,1485,1485
3,3,2020-10-03,2020-10-03,0,0,0,0,79,79,79,79,1564,1564
3,3,2020-10-04,2020-10-04,0,0,0,0,37,37,37,37,1601,1601
3,3,2020-10-05,2020-10-05,0,0,0,0,32,32,32,32,1633,1633
3,3,2020-10-06,2020-10-06,0,0,0,0,72,72,72,72,1705,1705
3,3,2020-10-07,2020-10-07,0,0,0,0,75,75,75,75,1780,1780
3,3,2020-10-08,2020-10-08,0,0,0,0,115,115,115,115,1895,1895
3,3,2020-10-09,2020-10-09,0,0,0,0,198,198,198,198,2093,2093
3,3,2020-10-10,2020-10-10,0,0,0,0,180,180,180,180,2273,2273
3,3,2020-10-11,2020-10-11,0,0,0,0,73,73,73,73,2346,2346
3,3,2020-10-12,2020-10-12,0,0,0,0,55,55,55,55,2401,2401
3,3,2020-10-13,2020-10-13,117,117,12,12,124,124,136,136,2537,2537
3,3,2020-10-14,2020-10-14,49,49,7,7,162,162,169,169,2706,2706
3,3,2020-10-15,2020-10-15,43,43,4,4,255,255,259,259,2965,2965
3,3,2020-10-16,2020-10-16,48,48,6,6,225,225,231,231,3196,3196
3,3,2020-10-17,2020-10-17,0,0,0,0,157,157,157,157,3353,3353
3,3,2020-10-18,2020-10-18,0,0,0,0,104,104,104,104,3457,3457
3,3,2020-10-19,2020-10-19,108,108,25,25,41,41,66,66,3523,3523
3,3,2020-10-20,2020-10-20,53,53,6,6,212,212,218,218,3741,3741
3,3,2020-10-21,2020-10-21,62,62,9,9,183,183,192,192,3933,3933
3,3,2020-10-22,2020-10-22,94,94,12,12,273,273,285,285,4218,4218
3,3,2020-10-23,2020-10-23,162,162,8,8,301,301,309,309,4527,4527
3,3,2020-10-24,2020-10-24,134,134,6,6,395,395,401,401,4928,4928
3,3,2020-10-25,2020-10-25,14,14,5,5,138,138,143,143,5071,5071
3,3,2020-10-26,2020-10-26,134,134,31,31,177,177,208,208,5279,5279
3,3,2020-10-27,2020-10-27,154,154,27,27,473,473,500,500,5779,5779
3,3,2020-10-28,2020-10-28,225,225,33,33,269,269,302,302,6081,6081
3,3,2020-10-29,2020-10-29,832,832,68,68,496,496,564,564,6645,6645
3,3,2020-10-30,2020-10-30,5385,5385,102,102,299,299,401,401,7046,7046
3,3,2020-10-31,2020-10-31,4801,4801,82,82,332,332,414,414,7460,7460
3,3,2020-11-01,2020-11-01,827,827,23,23,257,257,280,280,7740,7740
3,3,2020-11-02,2020-11-02,1901,1901,68,68,197,197,265,265,8005,8005
3,3,2020-11-03,2020-11-03,105,105,8,8,575,575,583,583,8588,8588
3,3,2020-11-04,2020-11-04,100,100,9,9,370,370,379,379,8967,8967
3,3,2020-11-05,2020-11-05,113,113,15,15,399,399,414,414,9381,9381
3,3,2020-11-06,2020-11-06,6977,6977,84,84,383,383,467,467,9848,9848
3,3,2020-11-07,2020-11-07,3721,3721,59,59,319,319,378,378,10226,10226
3,3,2020-11-08,2020-11-08,1231,1231,8,8,81,81,89,89,10315,10315
3,3,2020-11-09,2020-11-09,1455,1455,48,48,115,115,163,163,10478,10478
3,3,2020-11-10,2020-11-10,112,112,6,6,277,277,283,283,10761,10761
3,3,2020-11-11,2020-11-11,123,123,10,10,366,366,376,376,11137,11137
3,3,2020-11-12,2020-11-12,129,129,5,5,324,324,329,329,11466,11466
3,3,2020-11-13,2020-11-13,144,144,13,13,308,308,321,321,11787,11787
3,3,2020-11-14,2020-11-14,85,85,11,11,190,190,201,201,11988,11988
3,3,2020-11-15,2020-11-15,35,35,6,6,109,109,115,115,12103,12103
3,3,2020-11-16,2020-11-16,281,281,45,45,245,245,290,290,12393,12393
3,3,2020-11-17,2020-11-17,121,121,15,15,222,222,237,237,12630,12630
3,3,2020-11-18,2020-11-18,445,445,66,66,233,233,299,299,12929,12929
3,3,2020-11-19,2020-11-19,853,853,113,113,316,316,429,429,13358,13358
3,3,2020-11-20,2020-11-20,954,954,93,93,316,316,409,409,13767,13767
3,3,2020-11-21,2020-11-21,1385,1385,62,62,255,255,317,317,14084,14084
3,3,2020-11-22,2020-11-22,12,12,1,1,26,26,27,27,14111,14111
3,3,2020-11-23,2020-11-23,1308,1308,122,122,159,159,281,281,14392,14392
3,3,2020-11-24,2020-11-24,2861,2861,308,308,348,348,656,656,15048,15048
3,3,2020-11-25,2020-11-25,1604,1604,160,160,322,322,482,482,15530,15530
3,3,2020-11-26,2020-11-26,1374,1374,122,122,395,395,517,517,16047,16047
3,3,2020-11-27,2020-11-27,1548,1548,150,150,330,330,480,480,16527,16527
3,3,2020-11-28,2020-11-28,1144,1144,93,93,202,202,295,295,16822,16822
3,3,2020-11-29,2020-11-29,20,20,2,2,29,29,31,31,16853,16853
3,3,2020-11-30,2020-11-30,8983,8983,489,489,167,167,656,656,17509,17509
3,3,2020-12-01,2020-12-01,5993,5993,351,351,321,321,672,672,18181,18181
3,3,2020-12-02,2020-12-02,2076,2076,232,232,418,418,650,650,18831,18831
3,3,2020-12-03,2020-12-03,1892,1892,178,178,503,503,681,681,19512,19512
3,3,2020-12-04,2020-12-04,2734,2734,215,215,253,253,468,468,19980,19980
3,3,2020-12-05,2020-12-05,815,815,64,64,223,223,287,287,20267,20267
3,3,2020-12-06,2020-12-06,189,189,10,10,114,114,124,124,20391,20391
3,3,2020-12-07,2020-12-07,4292,4292,466,466,258,258,724,724,21115,21115
3,3,2020-12-08,2020-12-08,3962,3962,522,522,546,546,1068,1068,22183,22183
3,3,2020-12-09,2020-12-09,4275,4275,470,470,508,508,978,978,23161,23161
3,3,2020-12-10,2020-12-10,3848,3848,477,477,271,271,748,748,23909,23909
3,3,2020-12-11,2020-12-11,4381,4381,479,479,750,750,1229,1229,25138,25138
3,3,2020-12-12,2020-12-12,1122,1122,120,120,314,314,434,434,25572,25572
3,3,2020-12-13,2020-12-13,28,28,4,4,77,77,81,81,25653,25653
3,3,2020-12-14,2020-12-14,3573,3573,613,613,318,318,931,931,26584,26584
3,3,2020-12-15,2020-12-15,4299,4299,656,656,595,595,1251,1251,27835,27835
3,3,2020-12-16,2020-12-16,4947,4947,622,622,461,461,1083,1083,28918,28918
3,3,2020-12-17,2020-12-17,4193,4193,503,503,670,670,1173,1173,30091,30091
3,3,2020-12-18,2020-12-18,5213,5213,543,543,521,521,1064,1064,31155,31155
3,3,2020-12-19,2020-12-19,1761,1761,150,150,341,341,491,491,31646,31646
3,3,2020-12-20,2020-12-20,12771,12771,291,291,238,238,529,529,32175,32175
3,3,2020-12-21,2020-12-21,14535,14535,996,996,248,248,1244,1244,33419,33419
3,3,2020-12-22,2020-12-22,6291,6291,694,694,673,673,1367,1367,34786,34786
3,3,2020-12-23,2020-12-23,6923,6923,629,629,421,421,1050,1050,35836,35836
3,3,2020-12-24,2020-12-24,2450,2450,256,256,552,552,808,808,36644,36644
3,3,2020-12-25,2020-12-25,372,372,47,47,251,251,298,298,36942,36942
3,3,2020-12-26,2020-12-26,84,84,10,10,174,174,184,184,37126,37126
3,3,2020-12-27,2020-12-27,238,238,36,36,5,5,41,41,37167,37167
3,3,2020-12-28,2020-12-28,4700,4700,777,777,258,258,1035,1035,38202,38202
3,3,2020-12-29,2020-12-29,6997,6997,1018,1018,459,459,1477,1477,39679,39679
3,3,2020-12-30,2020-12-30,7544,7544,762,762,836,836,1598,1598,41277,41277
3,3,2020-12-31,2020-12-31,5500,5500,557,557,597,597,1154,1154,42431,42431
3,3,2021-01-01,2021-01-01,370,370,23,23,329,329,352,352,42783,42783
3,3,2021-01-02,2021-01-02,163,163,23,23,129,129,152,152,42935,42935
3,3,2021-01-03,2021-01-03,73,73,13,13,38,38,51,51,42986,42986
3,3,2021-01-04,2021-01-04,5401,5401,704,704,337,337,1041,1041,44027,44027
3,3,2021-01-05,2021-01-05,6785,6785,800,800,669,669,1469,1469,45496,45496
3,3,2021-01-06,2021-01-06,1085,1085,64,64,221,221,285,285,45781,45781
3,3,2021-01-07,2021-01-07,6222,6222,503,503,420,420,923,923,46704,46704
3,3,2021-01-08,2021-01-08,6878,6878,467,467,489,489,956,956,47660,47660
3,3,2021-01-09,2021-01-09,8094,8094,121,121,276,276,397,397,48057,48057
3,3,2021-01-10,2021-01-10,5015,5015,76,76,89,89,165,165,48222,48222
3,3,2021-01-11,2021-01-11,4179,4179,294,294,142,142,436,436,48658,48658
3,3,2021-01-12,2021-01-12,5083,5083,293,293,508,508,801,801,49459,49459
3,3,2021-01-13,2021-01-13,4300,4300,236,236,222,222,458,458,49917,49917
3,3,2021-01-14,2021-01-14,3144,3144,153,153,275,275,428,428,50345,50345
3,3,2021-01-15,2021-01-15,3974,3974,217,217,264,264,481,481,50826,50826
3,3,2021-01-16,2021-01-16,855,855,62,62,39,39,101,101,50927,50927
3,3,2021-01-17,2021-01-17,104,104,11,11,124,124,135,135,51062,51062
3,3,2021-01-18,2021-01-18,4745,4745,257,257,72,72,329,329,51391,51391
3,3,2021-01-19,2021-01-19,6737,6737,275,275,363,363,638,638,52029,52029
3,3,2021-01-20,2021-01-20,7920,7920,236,236,181,181,417,417,52446,52446
3,3,2021-01-21,2021-01-21,9025,9025,190,190,143,143,333,333,52779,52779
3,3,2021-01-22,2021-01-22,14122,14122,174,174,148,148,322,322,53101,53101
3,3,2021-01-23,2021-01-23,110748,110748,709,709,206,206,915,915,54016,54016
3,3,2021-01-24,2021-01-24,27546,27546,181,181,51,51,232,232,54248,54248
3,3,2021-01-25,2021-01-25,34429,34429,366,366,160,160,526,526,54774,54774
3,3,2021-01-26,2021-01-26,14524,14524,237,237,303,303,540,540,55314,55314
3,3,2021-01-27,2021-01-27,11938,11938,203,203,166,166,369,369,55683,55683
3,3,2021-01-28,2021-01-28,5592,5592,161,161,307,307,468,468,56151,56151
3,3,2021-01-29,2021-01-29,7351,7351,204,204,72,72,276,276,56427,56427
3,3,2021-01-30,2021-01-30,37400,37400,355,355,228,228,583,583,57010,57010
3,3,2021-01-31,2021-01-31,15926,15926,135,135,7,7,142,142,57152,57152
3,3,2021-02-01,2021-02-01,18545,18545,318,318,167,167,485,485,57637,57637
3,3,2021-02-02,2021-02-02,8462,8462,385,385,347,347,732,732,58369,58369
3,3,2021-02-03,2021-02-03,9326,9326,345,345,162,162,507,507,58876,58876
3,3,2021-02-04,2021-02-04,7184,7184,293,293,266,266,559,559,59435,59435
3,3,2021-02-05,2021-02-05,17372,17372,364,364,202,202,566,566,60001,60001
3,3,2021-02-06,2021-02-06,63855,63855,580,580,216,216,796,796,60797,60797
3,3,2021-02-07,2021-02-07,25968,25968,262,262,31,31,293,293,61090,61090
3,3,2021-02-08,2021-02-08,28880,28880,414,414,182,182,596,596,61686,61686
3,3,2021-02-09,2021-02-09,21884,21884,379,379,514,514,893,893,62579,62579
3,3,2021-02-10,2021-02-10,11716,11716,321,321,304,304,625,625,63204,63204
3,3,2021-02-11,2021-02-11,11522,11522,320,320,291,291,611,611,63815,63815
3,3,2021-02-12,2021-02-12,26590,26590,400,400,276,276,676,676,64491,64491
3,3,2021-02-13,2021-02-13,66190,66190,576,576,274,274,850,850,65341,65341
3,3,2021-02-14,2021-02-14,5647,5647,53,53,2,2,55,55,65396,65396
3,3,2021-02-15,2021-02-15,21891,21891,453,453,151,151,604,604,66000,66000
3,3,2021-02-16,2021-02-16,17177,17177,384,384,488,488,872,872,66872,66872
3,3,2021-02-17,2021-02-17,11264,11264,357,357,363,363,720,720,67592,67592
4,4,2020-09-03,2020-09-03,0,0,0,0,15,15,15,15,463,463
4,4,2020-09-04,2020-09-04,0,0,0,0,34,34,34,34,497,497
4,4,2020-09-05,2020-09-05,0,0,0,0,22,22,22,22,519,519
4,4,2020-09-07,2020-09-07,0,0,0,0,17,17,17,17,536,536
4,4,2020-09-08,2020-09-08,0,0,0,0,17,17,17,17,553,553
4,4,2020-09-09,2020-09-09,0,0,0,0,19,19,19,19,572,572
4,4,2020-09-10,2020-09-10,0,0,0,0,29,29,29,29,601,601
4,4,2020-09-11,2020-09-11,0,0,0,0,23,23,23,23,624,624
4,4,2020-09-12,2020-09-12,0,0,0,0,12,12,12,12,636,636
4,4,2020-09-13,2020-09-13,0,0,0,0,3,3,3,3,639,639
4,4,2020-09-14,2020-09-14,0,0,0,0,28,28,28,28,667,667
4,4,2020-09-15,2020-09-15,0,0,0,0,19,19,19,19,686,686
4,4,2020-09-16,2020-09-16,0,0,0,0,6,6,6,6,692,692
4,4,2020-09-17,2020-09-17,0,0,0,0,30,30,30,30,722,722
4,4,2020-09-18,2020-09-18,0,0,0,0,19,19,19,19,741,741
4,4,2020-09-19,2020-09-19,0,0,0,0,14,14,14,14,755,755
4,4,2020-09-20,2020-09-20,0,0,0,0,4,4,4,4,759,759
4,4,2020-09-21,2020-09-21,0,0,0,0,10,10,10,10,769,769
4,4,2020-09-22,2020-09-22,0,0,0,0,18,18,18,18,787,787
4,4,2020-09-23,2020-09-23,0,0,0,0,70,70,70,70,857,857
4,4,2020-09-24,2020-09-24,0,0,0,0,51,51,51,51,908,908
4,4,2020-09-25,2020-09-25,0,0,0,0,90,90,90,90,998,998
4,4,2020-09-26,2020-09-26,0,0,0,0,64,64,64,64,1062,1062
4,4,2020-09-27,2020-09-27,0,0,0,0,16,16,16,16,1078,1078
4,4,2020-09-28,2020-09-28,0,0,0,0,22,22,22,22,1100,1100
4,4,2020-09-29,2020-09-29,0,0,0,0,50,50,50,50,1150,1150
4,4,2020-09-30,2020-09-30,0,0,0,0,100,100,100,100,1250,1250
4,4,2020-10-01,2020-10-01,0,0,0,0,95,95,95,95,1345,1345
4,4,2020-10-02,2020-10-02,0,0,0,0,108,108,108,108,1453,1453
4,4,2020-10-03,2020-10-03,0,0,0,0,96,96,96,96,1549,1549
4,4,2020-10-04,2020-10-04,0,0,0,0,17,17,17,17,1566,1566
4,4,2020-10-05,2020-10-05,0,0,0,0,20,20,20,20,1586,1586
4,4,2020-10-06,2020-10-06,0,0,0,0,48,48,48,48,1634,1634
4,4,2020-10-07,2020-10-07,0,0,0,0,81,81,81,81,1715,1715
4,4,2020-10-08,2020-10-08,0,0,0,0,132,132,132,132,1847,1847
4,4,2020-10-09,2020-10-09,0,0,0,0,120,120,120,120,1967,1967
4,4,2020-10-10,2020-10-10,0,0,0,0,107,107,107,107,2074,2074
4,4,2020-10-11,2020-10-11,0,0,0,0,8,8,8,8,2082,2082
4,4,2020-10-12,2020-10-12,0,0,0,0,36,36,36,36,2118,2118
4,4,2020-10-13,2020-10-13,84,84,2,2,101,101,103,103,2221,2221
4,4,2020-10-14,2020-10-14,26,26,4,4,80,80,84,84,2305,2305
4,4,2020-10-15,2020-10-15,33,33,2,2,106,106,108,108,2413,2413
4,4,2020-10-16,2020-10-16,31,31,3,3,133,133,136,136,2549,2549
4,4,2020-10-17,2020-10-17,0,0,0,0,67,67,67,67,2616,2616
4,4,2020-10-18,2020-10-18,0,0,0,0,22,22,22,22,2638,2638
4,4,2020-10-19,2020-10-19,80,80,1,1,148,148,149,149,2787,2787
4,4,2020-10-20,2020-10-20,84,84,6,6,197,197,203,203,2990,2990
4,4,2020-10-21,2020-10-21,211,211,3,3,146,146,149,149,3139,3139
4,4,2020-10-22,2020-10-22,483,483,39,39,137,137,176,176,3315,3315
4,4,2020-10-23,2020-10-23,803,803,41,41,282,282,323,323,3638,3638
4,4,2020-10-24,2020-10-24,248,248,11,11,169,169,180,180,3818,3818
4,4,2020-10-25,2020-10-25,46,46,6,6,50,50,56,56,3874,3874
4,4,2020-10-26,2020-10-26,689,689,56,56,69,69,125,125,3999,3999
4,4,2020-10-27,2020-10-27,597,597,47,47,296,296,343,343,4342,4342
4,4,2020-10-28,2020-10-28,667,667,59,59,216,216,275,275,4617,4617
4,4,2020-10-29,2020-10-29,880,880,39,39,293,293,332,332,4949,4949
4,4,2020-10-30,2020-10-30,2401,2401,21,21,204,204,225,225,5174,5174
4,4,2020-10-31,2020-10-31,10600,10600,134,134,261,261,395,395,5569,5569
4,4,2020-11-01,2020-11-01,2573,2573,27,27,130,130,157,157,5726,5726
4,4,2020-11-02,2020-11-02,4254,4254,46,46,171,171,217,217,5943,5943
4,4,2020-11-03,2020-11-03,460,460,25,25,216,216,241,241,6184,6184
4,4,2020-11-04,2020-11-04,313,313,16,16,211,211,227,227,6411,6411
4,4,2020-11-05,2020-11-05,307,307,12,12,178,178,190,190,6601,6601
4,4,2020-11-06,2020-11-06,2296,2296,32,32,210,210,242,242,6843,6843
4,4,2020-11-07,2020-11-07,1050,1050,4,4,130,130,134,134,6977,6977
4,4,2020-11-08,2020-11-08,1494,1494,32,32,43,43,75,75,7052,7052
4,4,2020-11-09,2020-11-09,3179,3179,43,43,128,128,171,171,7223,7223
4,4,2020-11-10,2020-11-10,2662,2662,39,39,192,192,231,231,7454,7454
4,4,2020-11-11,2020-11-11,1269,1269,22,22,279,279,301,301,7755,7755
4,4,2020-11-12,2020-11-12,1230,1230,35,35,256,256,291,291,8046,8046
4,4,2020-11-13,2020-11-13,982,982,46,46,210,210,256,256,8302,8302
4,4,2020-11-14,2020-11-14,1163,1163,32,32,114,114,146,146,8448,8448
4,4,2020-11-15,2020-11-15,11,11,1,1,14,14,15,15,8463,8463
4,4,2020-11-16,2020-11-16,1911,1911,75,75,139,139,214,214,8677,8677
4,4,2020-11-17,2020-11-17,625,625,29,29,178,178,207,207,8884,8884
4,4,2020-11-18,2020-11-18,2186,2186,77,77,188,188,265,265,9149,9149
4,4,2020-11-19,2020-11-19,3086,3086,133,133,185,185,318,318,9467,9467
4,4,2020-11-20,2020-11-20,4121,4121,101,101,264,264,365,365,9832,9832
4,4,2020-11-21,2020-11-21,1121,1121,38,38,86,86,124,124,9956,9956
4,4,2020-11-22,2020-11-22,0,0,0,0,7,7,7,7,9963,9963
4,4,2020-11-23,2020-11-23,9768,9768,206,206,102,102,308,308,10271,10271
4,4,2020-11-24,2020-11-24,1191,1191,50,50,147,147,197,197,10468,10468
4,4,2020-11-25,2020-11-25,2059,2059,66,66,325,325,391,391,10859,10859
4,4,2020-11-26,2020-11-26,2319,2319,57,57,191,191,248,248,11107,11107
4,4,2020-11-27,2020-11-27,1272,1272,43,43,177,177,220,220,11327,11327
4,4,2020-11-28,2020-11-28,923,923,31,31,135,135,166,166,11493,11493
4,4,2020-11-29,2020-11-29,662,662,42,42,3,3,45,45,11538,11538
4,4,2020-11-30,2020-11-30,5043,5043,207,207,91,91,298,298,11836,11836
4,4,2020-12-01,2020-12-01,3074,3074,133,133,331,331,464,464,12300,12300
4,4,2020-12-02,2020-12-02,3896,3896,163,163,252,252,415,415,12715,12715
4,4,2020-12-03,2020-12-03,2726,2726,127,127,248,248,375,375,13090,13090
4,4,2020-12-04,2020-12-04,3133,3133,86,86,232,232,318,318,13408,13408
4,4,2020-12-05,2020-12-05,632,632,14,14,136,136,150,150,13558,13558
4,4,2020-12-06,2020-12-06,93,93,4,4,15,15,19,19,13577,13577
4,4,2020-12-07,2020-12-07,6816,6816,573,573,139,139,712,712,14289,14289
4,4,2020-12-08,2020-12-08,9377,9377,611,611,340,340,951,951,15240,15240
4,4,2020-12-09,2020-12-09,6268,6268,542,542,362,362,904,904,16144,16144
4,4,2020-12-10,2020-12-10,5356,5356,326,326,360,360,686,686,16830,16830
4,4,2020-12-11,2020-12-11,6658,6658,465,465,409,409,874,874,17704,17704
4,4,2020-12-12,2020-12-12,1957,1957,125,125,341,341,466,466,18170,18170
4,4,2020-12-13,2020-12-13,10,10,1,1,12,12,13,13,18183,18183
4,4,2020-12-14,2020-12-14,8916,8916,827,827,217,217,1044,1044,19227,19227
4,4,2020-12-15,2020-12-15,10134,10134,769,769,461,461,1230,1230,20457,20457
4,4,2020-12-16,2020-12-16,9216,9216,546,546,357,357,903,903,21360,21360
4,4,2020-12-17,2020-12-17,7219,7219,514,514,586,586,1100,1100,22460,22460
4,4,2020-12-18,2020-12-18,8871,8871,551,551,512,512,1063,1063,23523,23523
4,4,2020-12-19,2020-12-19,2418,2418,159,159,262,262,421,421,23944,23944
4,4,2020-12-20,2020-12-20,60,60,10,10,77,77,87,87,24031,24031
4,4,2020-12-21,2020-12-21,8695,8695,976,976,128,128,1104,1104,25135,25135
4,4,2020-12-22,2020-12-22,11909,11909,994,994,673,673,1667,1667,26802,26802
4,4,2020-12-23,2020-12-23,16057,16057,843,843,349,349,1192,1192,27994,27994
4,4,2020-12-24,2020-12-24,2037,2037,176,176,514,514,690,690,28684,28684
4,4,2020-12-25,2020-12-25,52,52,5,5,35,35,40,40,28724,28724
4,4,2020-12-26,2020-12-26,353,353,56,56,54,54,110,110,28834,28834
4,4,2020-12-27,2020-12-27,38,38,2,2,22,22,24,24,28858,28858
4,4,2020-12-28,2020-12-28,8152,8152,1271,1271,83,83,1354,1354,30212,30212
4,4,2020-12-29,2020-12-29,9461,9461,1286,1286,607,607,1893,1893,32105,32105
4,4,2020-12-30,2020-12-30,10590,10590,1160,1160,1094,1094,2254,2254,34359,34359
4,4,2020-12-31,2020-12-31,8608,8608,962,962,786,786,1748,1748,36107,36107
4,4,2021-01-01,2021-01-01,765,765,94,94,119,119,213,213,36320,36320
4,4,2021-01-02,2021-01-02,1116,1116,26,26,249,249,275,275,36595,36595
4,4,2021-01-03,2021-01-03,104,104,20,20,42,42,62,62,36657,36657
4,4,2021-01-04,2021-01-04,9517,9517,1270,1270,362,362,1632,1632,38289,38289
4,4,2021-01-05,2021-01-05,10019,10019,1204,1204,732,732,1936,1936,40225,40225
4,4,2021-01-06,2021-01-06,3586,3586,239,239,259,259,498,498,40723,40723
4,4,2021-01-07,2021-01-07,11249,11249,784,784,438,438,1222,1222,41945,41945
4,4,2021-01-08,2021-01-08,14723,14723,719,719,817,817,1536,1536,43481,43481
4,4,2021-01-09,2021-01-09,38165,38165,1090,1090,532,532,1622,1622,45103,45103
4,4,2021-01-10,2021-01-10,20571,20571,730,730,44,44,774,774,45877,45877
4,4,2021-01-11,2021-01-11,8690,8690,515,515,422,422,937,937,46814,46814
4,4,2021-01-12,2021-01-12,9566,9566,574,574,642,642,1216,1216,48030,48030
4,4,2021-01-13,2021-01-13,9664,9664,497,497,663,663,1160,1160,49190,49190
4,4,2021-01-14,2021-01-14,10708,10708,440,440,627,627,1067,1067,50257,50257
4,4,2021-01-15,2021-01-15,16131,16131,465,465,373,373,838,838,51095,51095
4,4,2021-01-16,2021-01-16,37019,37019,654,654,64,64,718,718,51813,51813
4,4,2021-01-17,2021-01-17,15336,15336,275,275,97,97,372,372,52185,52185
4,4,2021-01-18,2021-01-18,8973,8973,494,494,367,367,861,861,53046,53046
4,4,2021-01-19,2021-01-19,11401,11401,623,623,344,344,967,967,54013,54013
4,4,2021-01-20,2021-01-20,12122,12122,612,612,326,326,938,938,54951,54951
4,4,2021-01-21,2021-01-21,14715,14715,406,406,305,305,711,711,55662,55662
4,4,2021-01-22,2021-01-22,35839,35839,607,607,139,139,746,746,56408,56408
4,4,2021-01-23,2021-01-23,105597,105597,1580,1580,277,277,1857,1857,58265,58265
4,4,2021-01-24,2021-01-24,65411,65411,642,642,12,12,654,654,58919,58919
4,4,2021-01-25,2021-01-25,24101,24101,443,443,201,201,644,644,59563,59563
4,4,2021-01-26,2021-01-26,17636,17636,461,461,345,345,806,806,60369,60369
4,4,2021-01-27,2021-01-27,13694,13694,380,380,235,235,615,615,60984,60984
4,4,2021-01-28,2021-01-28,11323,11323,372,372,269,269,641,641,61625,61625
4,4,2021-01-29,2021-01-29,24023,24023,475,475,135,135,610,610,62235,62235
4,4,2021-01-30,2021-01-30,78911,78911,768,768,152,152,920,920,63155,63155
4,4,2021-01-31,2021-01-31,22821,22821,240,240,9,9,249,249,63404,63404
4,4,2021-02-01,2021-02-01,24770,24770,448,448,221,221,669,669,64073,64073
4,4,2021-02-02,2021-02-02,17758,17758,365,365,327,327,692,692,64765,64765
4,4,2021-02-03,2021-02-03,11038,11038,330,330,191,191,521,521,65286,65286
4,4,2021-02-04,2021-02-04,16155,16155,500,500,308,308,808,808,66094,66094
4,4,2021-02-05,2021-02-05,34907,34907,616,616,244,244,860,860,66954,66954
4,4,2021-02-06,2021-02-06,96018,96018,828,828,129,129,957,957,67911,67911
4,4,2021-02-07,2021-02-07,49225,49225,467,467,20,20,487,487,68398,68398
4,4,2021-02-08,2021-02-08,44303,44303,657,657,177,177,834,834,69232,69232
4,4,2021-02-09,2021-02-09,18978,18978,382,382,260,260,642,642,69874,69874
4,4,2021-02-10,2021-02-10,18256,18256,642,642,186,186,828,828,70702,70702
4,4,2021-02-11,2021-02-11,12636,12636,271,271,195,195,466,466,71168,71168
4,4,2021-02-12,2021-02-12,33160,33160,398,398,162,162,560,560,71728,71728
4,4,2021-02-13,2021-02-13,99269,99269,545,545,127,127,672,672,72400,72400
4,4,2021-02-14,2021-02-14,33924,33924,192,192,8,8,200,200,72600,72600
4,4,2021-02-15,2021-02-15,24550,24550,431,431,122,122,553,553,73153,73153
4,4,2021-02-16,2021-02-16,23837,23837,383,383,284,284,667,667,73820,73820
4,4,2021-02-17,2021-02-17,10727,10727,262,262,198,198,460,460,74280,74280
5,5,2020-09-03,2020-09-03,0,0,0,0,18,18,18,18,676,676
5,5,2020-09-04,2020-09-04,0,0,0,0,33,33,33,33,709,709
5,5,2020-09-05,2020-09-05,0,0,0,0,2,2,2,2,711,711
5,5,2020-09-07,2020-09-07,0,0,0,0,11,11,11,11,722,722
5,5,2020-09-08,2020-09-08,0,0,0,0,25,25,25,25,747,747
5,5,2020-09-09,2020-09-09,0,0,0,0,23,23,23,23,770,770
5,5,2020-09-10,2020-09-10,0,0,0,0,31,31,31,31,801,801
5,5,2020-09-11,2020-09-11,0,0,0,0,31,31,31,31,832,832
5,5,2020-09-12,2020-09-12,0,0,0,0,4,4,4,4,836,836
5,5,2020-09-13,2020-09-13,0,0,0,0,6,6,6,6,842,842
5,5,2020-09-14,2020-09-14,0,0,0,0,39,39,39,39,881,881
5,5,2020-09-15,2020-09-15,0,0,0,0,12,12,12,12,893,893
5,5,2020-09-16,2020-09-16,0,0,0,0,34,34,34,34,927,927
5,5,2020-09-17,2020-09-17,0,0,0,0,30,30,30,30,957,957
5,5,2020-09-18,2020-09-18,0,0,0,0,82,82,82,82,1039,1039
5,5,2020-09-19,2020-09-19,0,0,0,0,6,6,6,6,1045,1045
5,5,2020-09-20,2020-09-20,0,0,0,0,4,4,4,4,1049,1049
5,5,2020-09-21,2020-09-21,0,0,0,0,47,47,47,47,1096,1096
5,5,2020-09-22,2020-09-22,0,0,0,0,65,65,65,65,1161,1161
5,5,2020-09-23,2020-09-23,0,0,0,0,65,65,65,65,1226,1226
5,5,2020-09-24,2020-09-24,0,0,0,0,100,100,100,100,1326,1326
5,5,2020-09-25,2020-09-25,0,0,0,0,69,69,69,69,1395,1395
5,5,2020-09-26,2020-09-26,0,0,0,0,96,96,96,96,1491,1491
5,5,2020-09-27,2020-09-27,0,0,0,0,108,108,108,108,1599,1599
5,5,2020-09-28,2020-09-28,0,0,0,0,34,34,34,34,1633,1633
5,5,2020-09-29,2020-09-29,0,0,0,0,105,105,105,105,1738,1738
5,5,2020-09-30,2020-09-30,0,0,0,0,163,163,163,163,1901,1901
5,5,2020-10-01,2020-10-01,0,0,0,0,147,147,147,147,2048,2048
5,5,2020-10-02,2020-10-02,0,0,0,0,105,105,105,105,2153,2153
5,5,2020-10-03,2020-10-03,0,0,0,0,155,155,155,155,2308,2308
5,5,2020-10-04,2020-10-04,0,0,0,0,35,35,35,35,2343,2343
5,5,2020-10-05,2020-10-05,0,0,0,0,33,33,33,33,2376,2376
5,5,2020-10-06,2020-10-06,0,0,0,0,233,233,233,233,2609,2609
5,5,2020-10-07,2020-10-07,0,0,0,0,168,168,168,168,2777,2777
5,5,2020-10-08,2020-10-08,0,0,0,0,238,238,238,238,3015,3015
5,5,2020-10-09,2020-10-09,0,0,0,0,543,543,543,543,3558,3558
5,5,2020-10-10,2020-10-10,0,0,0,0,213,213,213,213,3771,3771
5,5,2020-10-11,2020-10-11,0,0,0,0,50,50,50,50,3821,3821
5,5,2020-10-12,2020-10-12,0,0,0,0,62,62,62,62,3883,3883
5,5,2020-10-13,2020-10-13,498,498,40,40,367,367,407,407,4290,4290
5,5,2020-10-14,2020-10-14,275,275,6,6,523,523,529,529,4819,4819
5,5,2020-10-15,2020-10-15,64,64,3,3,679,679,682,682,5501,5501
5,5,2020-10-16,2020-10-16,60,60,9,9,603,603,612,612,6113,6113
5,5,2020-10-17,2020-10-17,0,0,0,0,509,509,509,509,6622,6622
5,5,2020-10-18,2020-10-18,0,0,0,0,159,159,159,159,6781,6781
5,5,2020-10-19,2020-10-19,92,92,12,12,70,70,82,82,6863,6863
5,5,2020-10-20,2020-10-20,135,135,8,8,524,524,532,532,7395,7395
5,5,2020-10-21,2020-10-21,88,88,14,14,478,478,492,492,7887,7887
5,5,2020-10-22,2020-10-22,36,36,3,3,525,525,528,528,8415,8415
5,5,2020-10-23,2020-10-23,115,115,13,13,659,659,672,672,9087,9087
5,5,2020-10-24,2020-10-24,0,0,0,0,803,803,803,803,9890,9890
5,5,2020-10-25,2020-10-25,0,0,0,0,436,436,436,436,10326,10326
5,5,2020-10-26,2020-10-26,145,145,28,28,148,148,176,176,10502,10502
5,5,2020-10-27,2020-10-27,178,178,24,24,355,355,379,379,10881,10881
5,5,2020-10-28,2020-10-28,116,116,11,11,635,635,646,646,11527,11527
5,5,2020-10-29,2020-10-29,520,520,17,17,740,740,757,757,12284,12284
5,5,2020-10-30,2020-10-30,2636,2636,61,61,529,529,590,590,12874,12874
5,5,2020-10-31,2020-10-31,8166,8166,203,203,662,662,865,865,13739,13739
5,5,2020-11-01,2020-11-01,5226,5226,130,130,349,349,479,479,14218,14218
5,5,2020-11-02,2020-11-02,1082,1082,39,39,472,472,511,511,14729,14729
5,5,2020-11-03,2020-11-03,905,905,16,16,688,688,704,704,15433,15433
5,5,2020-11-04,2020-11-04,178,178,10,10,423,423,433,433,15866,15866
5,5,2020-11-05,2020-11-05,68,68,4,4,473,473,477,477,16343,16343
5,5,2020-11-06,2020-11-06,4128,4128,38,38,503,503,541,541,16884,16884
5,5,2020-11-07,2020-11-07,8263,8263,88,88,312,312,400,400,17284,17284
5,5,2020-11-08,2020-11-08,2231,2231,35,35,59,59,94,94,17378,17378
5,5,2020-11-09,2020-11-09,2365,2365,30,30,143,143,173,173,17551,17551
5,5,2020-11-10,2020-11-10,528,528,9,9,374,374,383,383,17934,17934
5,5,2020-11-11,2020-11-11,157,157,10,10,489,489,499,499,18433,18433
5,5,2020-11-12,2020-11-12,81,81,2,2,334,334,336,336,18769,18769
5,5,2020-11-13,2020-11-13,134,134,9,9,181,181,190,190,18959,18959
5,5,2020-11-14,2020-11-14,1049,1049,11,11,189,189,200,200,19159,19159
5,5,2020-11-15,2020-11-15,13,13,0,0,63,63,63,63,19222,19222
5,5,2020-11-16,2020-11-16,219,219,13,13,227,227,240,240,19462,19462
5,5,2020-11-17,2020-11-17,505,505,15,15,123,123,138,138,19600,19600
5,5,2020-11-18,2020-11-18,363,363,15,15,346,346,361,361,19961,19961
5,5,2020-11-19,2020-11-19,813,813,61,61,252,252,313,313,20274,20274
5,5,2020-11-20,2020-11-20,1119,1119,45,45,251,251,296,296,20570,20570
5,5,2020-11-21,2020-11-21,525,525,20,20,61,61,81,81,20651,20651
5,5,2020-11-22,2020-11-22,0,0,0,0,11,11,11,11,20662,20662
5,5,2020-11-23,2020-11-23,803,803,44,44,170,170,214,214,20876,20876
5,5,2020-11-24,2020-11-24,2159,2159,67,67,213,213,280,280,21156,21156
5,5,2020-11-25,2020-11-25,1266,1266,49,49,225,225,274,274,21430,21430
5,5,2020-11-26,2020-11-26,1161,1161,57,57,189,189,246,246,21676,21676
5,5,2020-11-27,2020-11-27,959,959,46,46,218,218,264,264,21940,21940
5,5,2020-11-28,2020-11-28,364,364,15,15,99,99,114,114,22054,22054
5,5,2020-11-29,2020-11-29,88,88,7,7,18,18,25,25,22079,22079
5,5,2020-11-30,2020-11-30,5523,5523,291,291,202,202,493,493,22572,22572
5,5,2020-12-01,2020-12-01,6838,6838,309,309,209,209,518,518,23090,23090
5,5,2020-12-02,2020-12-02,1635,1635,82,82,181,181,263,263,23353,23353
5,5,2020-12-03,2020-12-03,1531,1531,119,119,237,237,356,356,23709,23709
5,5,2020-12-04,2020-12-04,2967,2967,120,120,228,228,348,348,24057,24057
5,5,2020-12-05,2020-12-05,1282,1282,45,45,98,98,143,143,24200,24200
5,5,2020-12-06,2020-12-06,138,138,4,4,15,15,19,19,24219,24219
5,5,2020-12-07,2020-12-07,2395,2395,121,121,348,348,469,469,24688,24688
5,5,2020-12-08,2020-12-08,4103,4103,188,188,331,331,519,519,25207,25207
5,5,2020-12-09,2020-12-09,2722,2722,163,163,392,392,555,555,25762,25762
5,5,2020-12-10,2020-12-10,10256,10256,849,849,166,166,1015,1015,26777,26777
5,5,2020-12-11,2020-12-11,4878,4878,282,282,455,455,737,737,27514,27514
5,5,2020-12-12,2020-12-12,1114,1114,53,53,95,95,148,148,27662,27662
5,5,2020-12-13,2020-12-13,579,579,64,64,26,26,90,90,27752,27752
5,5,2020-12-14,2020-12-14,4759,4759,358,358,321,321,679,679,28431,28431
5,5,2020-12-15,2020-12-15,4786,4786,387,387,528,528,915,915,29346,29346
5,5,2020-12-16,2020-12-16,4670,4670,305,305,333,333,638,638,29984,29984
5,5,2020-12-17,2020-12-17,4614,4614,281,281,500,500,781,781,30765,30765
5,5,2020-12-18,2020-12-18,7429,7429,402,402,333,333,735,735,31500,31500
5,5,2020-12-19,2020-12-19,2224,2224,144,144,208,208,352,352,31852,31852
5,5,2020-12-20,2020-12-20,652,652,73,73,36,36,109,109,31961,31961
5,5,2020-12-21,2020-12-21,13810,13810,1107,1107,444,444,1551,1551,33512,33512
5,5,2020-12-22,2020-12-22,14211,14211,1023,1023,519,519,1542,1542,35054,35054
5,5,2020-12-23,2020-12-23,18270,18270,1012,1012,228,228,1240,1240,36294,36294
5,5,2020-12-24,2020-12-24,1093,1093,75,75,643,643,718,718,37012,37012
5,5,2020-12-25,2020-12-25,121,121,10,10,66,66,76,76,37088,37088
5,5,2020-12-26,2020-12-26,138,138,14,14,135,135,149,149,37237,37237
5,5,2020-12-27,2020-12-27,742,742,80,80,40,40,120,120,37357,37357
5,5,2020-12-28,2020-12-28,11772,11772,1002,1002,406,406,1408,1408,38765,38765
5,5,2020-12-29,2020-12-29,11870,11870,1070,1070,256,256,1326,1326,40091,40091
5,5,2020-12-30,2020-12-30,13017,13017,860,860,1038,1038,1898,1898,41989,41989
5,5,2020-12-31,2020-12-31,11181,11181,833,833,395,395,1228,1228,43217,43217
5,5,2021-01-01,2021-01-01,588,588,36,36,118,118,154,154,43371,43371
5,5,2021-01-02,2021-01-02,832,832,86,86,98,98,184,184,43555,43555
5,5,2021-01-03,2021-01-03,37,37,4,4,13,13,17,17,43572,43572
5,5,2021-01-04,2021-01-04,10498,10498,949,949,479,479,1428,1428,45000,45000
5,5,2021-01-05,2021-01-05,12239,12239,929,929,717,717,1646,1646,46646,46646
5,5,2021-01-06,2021-01-06,1427,1427,89,89,145,145,234,234,46880,46880
5,5,2021-01-07,2021-01-07,25524,25524,1880,1880,438,438,2318,2318,49198,49198
5,5,2021-01-08,2021-01-08,9863,9863,511,511,413,413,924,924,50122,50122
5,5,2021-01-09,2021-01-09,2077,2077,85,85,192,192,277,277,50399,50399
5,5,2021-01-10,2021-01-10,196,196,7,7,38,38,45,45,50444,50444
5,5,2021-01-11,2021-01-11,10995,10995,510,510,351,351,861,861,51305,51305
5,5,2021-01-12,2021-01-12,9350,9350,426,426,376,376,802,802,52107,52107
5,5,2021-01-13,2021-01-13,11895,11895,554,554,247,247,801,801,52908,52908
5,5,2021-01-14,2021-01-14,5890,5890,253,253,166,166,419,419,53327,53327
5,5,2021-01-15,2021-01-15,7351,7351,202,202,248,248,450,450,53777,53777
5,5,2021-01-16,2021-01-16,322,322,8,8,14,14,22,22,53799,53799
5,5,2021-01-17,2021-01-17,115,115,2,2,95,95,97,97,53896,53896
5,5,2021-01-18,2021-01-18,12821,12821,334,334,236,236,570,570,54466,54466
5,5,2021-01-19,2021-01-19,17975,17975,405,405,245,245,650,650,55116,55116
5,5,2021-01-20,2021-01-20,17123,17123,165,165,236,236,401,401,55517,55517
5,5,2021-01-21,2021-01-21,19529,19529,178,178,116,116,294,294,55811,55811
5,5,2021-01-22,2021-01-22,28275,28275,228,228,163,163,391,391,56202,56202
5,5,2021-01-23,2021-01-23,88501,88501,395,395,91,91,486,486,56688,56688
5,5,2021-01-24,2021-01-24,32610,32610,138,138,22,22,160,160,56848,56848
5,5,2021-01-25,2021-01-25,18746,18746,131,131,159,159,290,290,57138,57138
5,5,2021-01-26,2021-01-26,49746,49746,342,342,245,245,587,587,57725,57725
5,5,2021-01-27,2021-01-27,7100,7100,123,123,256,256,379,379,58104,58104
5,5,2021-01-28,2021-01-28,5772,5772,174,174,240,240,414,414,58518,58518
5,5,2021-01-29,2021-01-29,17426,17426,214,214,30,30,244,244,58762,58762
5,5,2021-01-30,2021-01-30,15533,15533,156,156,85,85,241,241,59003,59003
5,5,2021-01-31,2021-01-31,43,43,1,1,11,11,12,12,59015,59015
5,5,2021-02-01,2021-02-01,18961,18961,334,334,220,220,554,554,59569,59569
5,5,2021-02-02,2021-02-02,10087,10087,280,280,216,216,496,496,60065,60065
5,5,2021-02-03,2021-02-03,9002,9002,252,252,194,194,446,446,60511,60511
5,5,2021-02-04,2021-02-04,11539,11539,232,232,238,238,470,470,60981,60981
5,5,2021-02-05,2021-02-05,30832,30832,293,293,248,248,541,541,61522,61522
5,5,2021-02-06,2021-02-06,66568,66568,325,325,71,71,396,396,61918,61918
5,5,2021-02-07,2021-02-07,38639,38639,199,199,24,24,223,223,62141,62141
5,5,2021-02-08,2021-02-08,43823,43823,408,408,160,160,568,568,62709,62709
5,5,2021-02-09,2021-02-09,25199,25199,278,278,377,377,655,655,63364,63364
5,5,2021-02-10,2021-02-10,17038,17038,259,259,259,259,518,518,63882,63882
5,5,2021-02-11,2021-02-11,23754,23754,293,293,228,228,521,521,64403,64403
5,5,2021-02-12,2021-02-12,41514,41514,330,330,242,242,572,572,64975,64975
5,5,2021-02-13,2021-02-13,65302,65302,432,432,91,91,523,523,65498,65498
5,5,2021-02-14,2021-02-14,20509,20509,180,180,30,30,210,210,65708,65708
5,5,2021-02-15,2021-02-15,32530,32530,316,316,230,230,546,546,66254,66254
5,5,2021-02-16,2021-02-16,23647,23647,324,324,321,321,645,645,66899,66899
5,5,2021-02-17,2021-02-17,17650,17650,331,331,269,269,600,600,67499,67499
6,6,2020-09-03,2020-09-03,0,0,0,0,5,5,5,5,308,308
6,6,2020-09-04,2020-09-04,0,0,0,0,9,9,9,9,317,317
6,6,2020-09-07,2020-09-07,0,0,0,0,2,2,2,2,319,319
6,6,2020-09-08,2020-09-08,0,0,0,0,5,5,5,5,324,324
6,6,2020-09-09,2020-09-09,0,0,0,0,13,13,13,13,337,337
6,6,2020-09-10,2020-09-10,0,0,0,0,11,11,11,11,348,348
6,6,2020-09-11,2020-09-11,0,0,0,0,19,19,19,19,367,367
6,6,2020-09-12,2020-09-12,0,0,0,0,5,5,5,5,372,372
6,6,2020-09-13,2020-09-13,0,0,0,0,1,1,1,1,373,373
6,6,2020-09-14,2020-09-14,0,0,0,0,13,13,13,13,386,386
6,6,2020-09-15,2020-09-15,0,0,0,0,2,2,2,2,388,388
6,6,2020-09-16,2020-09-16,0,0,0,0,6,6,6,6,394,394
6,6,2020-09-17,2020-09-17,0,0,0,0,14,14,14,14,408,408
6,6,2020-09-18,2020-09-18,0,0,0,0,24,24,24,24,432,432
6,6,2020-09-19,2020-09-19,0,0,0,0,3,3,3,3,435,435
6,6,2020-09-21,2020-09-21,0,0,0,0,3,3,3,3,438,438
6,6,2020-09-22,2020-09-22,0,0,0,0,25,25,25,25,463,463
6,6,2020-09-23,2020-09-23,0,0,0,0,17,17,17,17,480,480
6,6,2020-09-24,2020-09-24,0,0,0,0,25,25,25,25,505,505
6,6,2020-09-25,2020-09-25,0,0,0,0,29,29,29,29,534,534
6,6,2020-09-26,2020-09-26,0,0,0,0,24,24,24,24,558,558
6,6,2020-09-27,2020-09-27,0,0,0,0,20,20,20,20,578,578
6,6,2020-09-29,2020-09-29,0,0,0,0,24,24,24,24,602,602
6,6,2020-09-30,2020-09-30,0,0,0,0,60,60,60,60,662,662
6,6,2020-10-01,2020-10-01,0,0,0,0,49,49,49,49,711,711
6,6,2020-10-02,2020-10-02,0,0,0,0,74,74,74,74,785,785
6,6,2020-10-03,2020-10-03,0,0,0,0,37,37,37,37,822,822
6,6,2020-10-04,2020-10-04,0,0,0,0,8,8,8,8,830,830
6,6,2020-10-05,2020-10-05,0,0,0,0,49,49,49,49,879,879
6,6,2020-10-06,2020-10-06,0,0,0,0,68,68,68,68,947,947
6,6,2020-10-07,2020-10-07,0,0,0,0,124,124,124,124,1071,1071
6,6,2020-10-08,2020-10-08,0,0,0,0,99,99,99,99,1170,1170
6,6,2020-10-09,2020-10-09,0,0,0,0,128,128,128,128,1298,1298
6,6,2020-10-10,2020-10-10,0,0,0,0,53,53,53,53,1351,1351
6,6,2020-10-11,2020-10-11,0,0,0,0,14,14,14,14,1365,1365
6,6,2020-10-12,2020-10-12,13,13,0,0,11,11,11,11,1376,1376
6,6,2020-10-13,2020-10-13,180,180,11,11,151,151,162,162,1538,1538
6,6,2020-10-14,2020-10-14,32,32,1,1,139,139,140,140,1678,1678
6,6,2020-10-15,2020-10-15,30,30,1,1,133,133,134,134,1812,1812
6,6,2020-10-16,2020-10-16,40,40,3,3,224,224,227,227,2039,2039
6,6,2020-10-17,2020-10-17,0,0,0,0,91,91,91,91,2130,2130
6,6,2020-10-18,2020-10-18,0,0,0,0,49,49,49,49,2179,2179
6,6,2020-10-19,2020-10-19,83,83,12,12,27,27,39,39,2218,2218
6,6,2020-10-20,2020-10-20,69,69,3,3,210,210,213,213,2431,2431
6,6,2020-10-21,2020-10-21,269,269,3,3,209,209,212,212,2643,2643
6,6,2020-10-22,2020-10-22,277,277,24,24,264,264,288,288,2931,2931
6,6,2020-10-23,2020-10-23,259,259,29,29,231,231,260,260,3191,3191
6,6,2020-10-24,2020-10-24,126,126,12,12,315,315,327,327,3518,3518
6,6,2020-10-25,2020-10-25,151,151,11,11,50,50,61,61,3579,3579
6,6,2020-10-26,2020-10-26,261,261,29,29,38,38,67,67,3646,3646
6,6,2020-10-27,2020-10-27,694,694,40,40,266,266,306,306,3952,3952
6,6,2020-10-28,2020-10-28,332,332,30,30,285,285,315,315,4267,4267
6,6,2020-10-29,2020-10-29,1011,1011,42,42,372,372,414,414,4681,4681
6,6,2020-10-30,2020-10-30,2849,2849,20,20,254,254,274,274,4955,4955
6,6,2020-10-31,2020-10-31,13632,13632,116,116,198,198,314,314,5269,5269
6,6,2020-11-01,2020-11-01,2713,2713,42,42,101,101,143,143,5412,5412
6,6,2020-11-02,2020-11-02,2312,2312,65,65,90,90,155,155,5567,5567
6,6,2020-11-03,2020-11-03,1336,1336,4,4,246,246,250,250,5817,5817
6,6,2020-11-04,2020-11-04,1379,1379,13,13,254,254,267,267,6084,6084
6,6,2020-11-05,2020-11-05,296,296,33,33,240,240,273,273,6357,6357
6,6,2020-11-06,2020-11-06,2512,2512,16,16,227,227,243,243,6600,6600
6,6,2020-11-07,2020-11-07,8922,8922,94,94,164,164,258,258,6858,6858
6,6,2020-11-08,2020-11-08,799,799,16,16,82,82,98,98,6956,6956
6,6,2020-11-09,2020-11-09,2709,2709,31,31,80,80,111,111,7067,7067
6,6,2020-11-10,2020-11-10,481,481,18,18,263,263,281,281,7348,7348
6,6,2020-11-11,2020-11-11,446,446,9,9,224,224,233,233,7581,7581
6,6,2020-11-12,2020-11-12,996,996,44,44,218,218,262,262,7843,7843
6,6,2020-11-13,2020-11-13,563,563,11,11,157,157,168,168,8011,8011
6,6,2020-11-14,2020-11-14,307,307,2,2,73,73,75,75,8086,8086
6,6,2020-11-15,2020-11-15,66,66,2,2,52,52,54,54,8140,8140
6,6,2020-11-16,2020-11-16,373,373,22,22,106,106,128,128,8268,8268
6,6,2020-11-17,2020-11-17,613,613,35,35,52,52,87,87,8355,8355
6,6,2020-11-18,2020-11-18,649,649,62,62,153,153,215,215,8570,8570
6,6,2020-11-19,2020-11-19,1194,1194,82,82,170,170,252,252,8822,8822
6,6,2020-11-20,2020-11-20,1977,1977,105,105,127,127,232,232,9054,9054
6,6,2020-11-21,2020-11-21,899,899,14,14,52,52,66,66,9120,9120
6,6,2020-11-22,2020-11-22,73,73,1,1,38,38,39,39,9159,9159
6,6,2020-11-23,2020-11-23,10139,10139,191,191,66,66,257,257,9416,9416
6,6,2020-11-24,2020-11-24,2329,2329,67,67,166,166,233,233,9649,9649
6,6,2020-11-25,2020-11-25,1844,1844,84,84,170,170,254,254,9903,9903
6,6,2020-11-26,2020-11-26,1946,1946,91,91,209,209,300,300,10203,10203
6,6,2020-11-27,2020-11-27,2050,2050,120,120,219,219,339,339,10542,10542
6,6,2020-11-28,2020-11-28,1327,1327,48,48,81,81,129,129,10671,10671
6,6,2020-11-29,2020-11-29,83,83,3,3,19,19,22,22,10693,10693
6,6,2020-11-30,2020-11-30,3987,3987,226,226,75,75,301,301,10994,10994
6,6,2020-12-01,2020-12-01,2753,2753,134,134,215,215,349,349,11343,11343
6,6,2020-12-02,2020-12-02,4478,4478,186,186,217,217,403,403,11746,11746
6,6,2020-12-03,2020-12-03,3140,3140,227,227,240,240,467,467,12213,12213
6,6,2020-12-04,2020-12-04,3897,3897,174,174,339,339,513,513,12726,12726
6,6,2020-12-05,2020-12-05,985,985,33,33,109,109,142,142,12868,12868
6,6,2020-12-06,2020-12-06,368,368,9,9,121,121,130,130,12998,12998
6,6,2020-12-07,2020-12-07,2146,2146,140,140,175,175,315,315,13313,13313
6,6,2020-12-08,2020-12-08,3943,3943,276,276,256,256,532,532,13845,13845
6,6,2020-12-09,2020-12-09,3919,3919,212,212,323,323,535,535,14380,14380
6,6,2020-12-10,2020-12-10,5378,5378,351,351,280,280,631,631,15011,15011
6,6,2020-12-11,2020-12-11,6817,6817,374,374,468,468,842,842,15853,15853
6,6,2020-12-12,2020-12-12,2732,2732,138,138,137,137,275,275,16128,16128
6,6,2020-12-13,2020-12-13,20,20,1,1,122,122,123,123,16251,16251
6,6,2020-12-14,2020-12-14,3992,3992,259,259,148,148,407,407,16658,16658
6,6,2020-12-15,2020-12-15,5748,5748,430,430,336,336,766,766,17424,17424
6,6,2020-12-16,2020-12-16,10637,10637,557,557,379,379,936,936,18360,18360
6,6,2020-12-17,2020-12-17,9246,9246,772,772,468,468,1240,1240,19600,19600
6,6,2020-12-18,2020-12-18,6868,6868,414,414,432,432,846,846,20446,20446
6,6,2020-12-19,2020-12-19,3053,3053,135,135,170,170,305,305,20751,20751
6,6,2020-12-20,2020-12-20,113,113,14,14,155,155,169,169,20920,20920
6,6,2020-12-21,2020-12-21,5346,5346,448,448,286,286,734,734,21654,21654
6,6,2020-12-22,2020-12-22,9058,9058,624,624,307,307,931,931,22585,22585
6,6,2020-12-23,2020-12-23,10617,10617,507,507,368,368,875,875,23460,23460
6,6,2020-12-24,2020-12-24,3809,3809,135,135,452,452,587,587,24047,24047
6,6,2020-12-25,2020-12-25,235,235,6,6,65,65,71,71,24118,24118
6,6,2020-12-26,2020-12-26,291,291,32,32,61,61,93,93,24211,24211
6,6,2020-12-27,2020-12-27,521,521,25,25,116,116,141,141,24352,24352
6,6,2020-12-28,2020-12-28,6362,6362,703,703,131,131,834,834,25186,25186
6,6,2020-12-29,2020-12-29,8507,8507,738,738,240,240,978,978,26164,26164
6,6,2020-12-30,2020-12-30,7959,7959,550,550,593,593,1143,1143,27307,27307
6,6,2020-12-31,2020-12-31,7462,7462,719,719,499,499,1218,1218,28525,28525
6,6,2021-01-01,2021-01-01,2150,2150,135,135,220,220,355,355,28880,28880
6,6,2021-01-02,2021-01-02,666,666,83,83,123,123,206,206,29086,29086
6,6,2021-01-03,2021-01-03,175,175,13,13,199,199,212,212,29298,29298
6,6,2021-01-04,2021-01-04,6333,6333,571,571,130,130,701,701,29999,29999
6,6,2021-01-05,2021-01-05,6860,6860,480,480,372,372,852,852,30851,30851
6,6,2021-01-06,2021-01-06,3579,3579,210,210,305,305,515,515,31366,31366
6,6,2021-01-07,2021-01-07,4297,4297,260,260,127,127,387,387,31753,31753
6,6,2021-01-08,2021-01-08,8459,8459,383,383,435,435,818,818,32571,32571
6,6,2021-01-09,2021-01-09,2835,2835,107,107,297,297,404,404,32975,32975
6,6,2021-01-10,2021-01-10,106,106,4,4,110,110,114,114,33089,33089
6,6,2021-01-11,2021-01-11,7445,7445,411,411,76,76,487,487,33576,33576
6,6,2021-01-12,2021-01-12,6585,6585,287,287,194,194,481,481,34057,34057
6,6,2021-01-13,2021-01-13,5751,5751,191,191,235,235,426,426,34483,34483
6,6,2021-01-14,2021-01-14,5763,5763,320,320,220,220,540,540,35023,35023
6,6,2021-01-15,2021-01-15,6515,6515,203,203,164,164,367,367,35390,35390
6,6,2021-01-16,2021-01-16,1929,1929,56,56,58,58,114,114,35504,35504
6,6,2021-01-17,2021-01-17,8227,8227,77,77,110,110,187,187,35691,35691
6,6,2021-01-18,2021-01-18,5448,5448,277,277,94,94,371,371,36062,36062
6,6,2021-01-19,2021-01-19,10967,10967,321,321,213,213,534,534,36596,36596
6,6,2021-01-20,2021-01-20,9046,9046,186,186,231,231,417,417,37013,37013
6,6,2021-01-21,2021-01-21,16360,16360,351,351,194,194,545,545,37558,37558
6,6,2021-01-22,2021-01-22,27140,27140,341,341,175,175,516,516,38074,38074
6,6,2021-01-23,2021-01-23,84113,84113,503,503,142,142,645,645,38719,38719
6,6,2021-01-24,2021-01-24,29506,29506,239,239,38,38,277,277,38996,38996
6,6,2021-01-25,2021-01-25,31746,31746,369,369,82,82,451,451,39447,39447
6,6,2021-01-26,2021-01-26,19961,19961,288,288,238,238,526,526,39973,39973
6,6,2021-01-27,2021-01-27,10828,10828,197,197,191,191,388,388,40361,40361
6,6,2021-01-28,2021-01-28,14146,14146,342,342,218,218,560,560,40921,40921
6,6,2021-01-29,2021-01-29,15431,15431,237,237,130,130,367,367,41288,41288
6,6,2021-01-30,2021-01-30,46470,46470,379,379,163,163,542,542,41830,41830
6,6,2021-01-31,2021-01-31,24720,24720,219,219,34,34,253,253,42083,42083
6,6,2021-02-01,2021-02-01,19451,19451,379,379,75,75,454,454,42537,42537
6,6,2021-02-02,2021-02-02,14984,14984,319,319,277,277,596,596,43133,43133
6,6,2021-02-03,2021-02-03,9303,9303,243,243,350,350,593,593,43726,43726
6,6,2021-02-04,2021-02-04,13583,13583,413,413,240,240,653,653,44379,44379
6,6,2021-02-05,2021-02-05,23914,23914,358,358,282,282,640,640,45019,45019
6,6,2021-02-06,2021-02-06,63572,63572,545,545,178,178,723,723,45742,45742
6,6,2021-02-07,2021-02-07,23673,23673,142,142,70,70,212,212,45954,45954
6,6,2021-02-08,2021-02-08,41535,41535,589,589,103,103,692,692,46646,46646
6,6,2021-02-09,2021-02-09,17851,17851,349,349,329,329,678,678,47324,47324
6,6,2021-02-10,2021-02-10,13858,13858,320,320,333,333,653,653,47977,47977
6,6,2021-02-11,2021-02-11,21721,21721,384,384,305,305,689,689,48666,48666
6,6,2021-02-12,2021-02-12,35403,35403,521,521,312,312,833,833,49499,49499
6,6,2021-02-13,2021-02-13,42420,42420,399,399,202,202,601,601,50100,50100
6,6,2021-02-14,2021-02-14,14937,14937,127,127,60,60,187,187,50287,50287
6,6,2021-02-15,2021-02-15,35028,35028,554,554,118,118,672,672,50959,50959
6,6,2021-02-16,2021-02-16,20596,20596,380,380,338,338,718,718,51677,51677
6,6,2021-02-17,2021-02-17,16148,16148,384,384,415,415,799,799,52476,52476
7,7,2020-09-03,2020-09-03,0,0,0,0,8,8,8,8,591,591
7,7,2020-09-04,2020-09-04,0,0,0,0,24,24,24,24,615,615
7,7,2020-09-05,2020-09-05,0,0,0,0,7,7,7,7,622,622
7,7,2020-09-06,2020-09-06,0,0,0,0,3,3,3,3,625,625
7,7,2020-09-07,2020-09-07,0,0,0,0,5,5,5,5,630,630
7,7,2020-09-08,2020-09-08,0,0,0,0,23,23,23,23,653,653
7,7,2020-09-09,2020-09-09,0,0,0,0,21,21,21,21,674,674
7,7,2020-09-10,2020-09-10,0,0,0,0,10,10,10,10,684,684
7,7,2020-09-11,2020-09-11,0,0,0,0,15,15,15,15,699,699
7,7,2020-09-12,2020-09-12,0,0,0,0,4,4,4,4,703,703
7,7,2020-09-13,2020-09-13,0,0,0,0,3,3,3,3,706,706
7,7,2020-09-14,2020-09-14,0,0,0,0,47,47,47,47,753,753
7,7,2020-09-15,2020-09-15,0,0,0,0,10,10,10,10,763,763
7,7,2020-09-16,2020-09-16,0,0,0,0,8,8,8,8,771,771
7,7,2020-09-17,2020-09-17,0,0,0,0,25,25,25,25,796,796
7,7,2020-09-18,2020-09-18,0,0,0,0,29,29,29,29,825,825
7,7,2020-09-19,2020-09-19,0,0,0,0,12,12,12,12,837,837
7,7,2020-09-20,2020-09-20,0,0,0,0,5,5,5,5,842,842
7,7,2020-09-21,2020-09-21,0,0,0,0,14,14,14,14,856,856
7,7,2020-09-22,2020-09-22,0,0,0,0,29,29,29,29,885,885
7,7,2020-09-23,2020-09-23,0,0,0,0,55,55,55,55,940,940
7,7,2020-09-24,2020-09-24,0,0,0,0,52,52,52,52,992,992
7,7,2020-09-25,2020-09-25,0,0,0,0,91,91,91,91,1083,1083
7,7,2020-09-26,2020-09-26,0,0,0,0,72,72,72,72,1155,1155
7,7,2020-09-27,2020-09-27,0,0,0,0,10,10,10,10,1165,1165
7,7,2020-09-28,2020-09-28,0,0,0,0,51,51,51,51,1216,1216
7,7,2020-09-29,2020-09-29,0,0,0,0,156,156,156,156,1372,1372
7,7,2020-09-30,2020-09-30,0,0,0,0,121,121,121,121,1493,1493
7,7,2020-10-01,2020-10-01,0,0,0,0,136,136,136,136,1629,1629
7,7,2020-10-02,2020-10-02,0,0,0,0,149,149,149,149,1778,1778
7,7,2020-10-03,2020-10-03,0,0,0,0,204,204,204,204,1982,1982
7,7,2020-10-04,2020-10-04,0,0,0,0,118,118,118,118,2100,2100
7,7,2020-10-05,2020-10-05,0,0,0,0,84,84,84,84,2184,2184
7,7,2020-10-06,2020-10-06,0,0,0,0,166,166,166,166,2350,2350
7,7,2020-10-07,2020-10-07,0,0,0,0,244,244,244,244,2594,2594
7,7,2020-10-08,2020-10-08,0,0,0,0,245,245,245,245,2839,2839
7,7,2020-10-09,2020-10-09,0,0,0,0,406,406,406,406,3245,3245
7,7,2020-10-10,2020-10-10,0,0,0,0,248,248,248,248,3493,3493
7,7,2020-10-11,2020-10-11,0,0,0,0,127,127,127,127,3620,3620
7,7,2020-10-12,2020-10-12,369,369,35,35,214,214,249,249,3869,3869
7,7,2020-10-13,2020-10-13,56,56,6,6,264,264,270,270,4139,4139
7,7,2020-10-14,2020-10-14,64,64,10,10,451,451,461,461,4600,4600
7,7,2020-10-15,2020-10-15,103,103,18,18,435,435,453,453,5053,5053
7,7,2020-10-16,2020-10-16,60,60,3,3,388,388,391,391,5444,5444
7,7,2020-10-17,2020-10-17,0,0,0,0,342,342,342,342,5786,5786
7,7,2020-10-18,2020-10-18,0,0,0,0,209,209,209,209,5995,5995
7,7,2020-10-19,2020-10-19,250,250,15,15,140,140,155,155,6150,6150
7,7,2020-10-20,2020-10-20,72,72,7,7,493,493,500,500,6650,6650
7,7,2020-10-21,2020-10-21,66,66,8,8,383,383,391,391,7041,7041
7,7,2020-10-22,2020-10-22,426,426,30,30,646,646,676,676,7717,7717
7,7,2020-10-23,2020-10-23,226,226,8,8,750,750,758,758,8475,8475
7,7,2020-10-24,2020-10-24,212,212,12,12,719,719,731,731,9206,9206
7,7,2020-10-25,2020-10-25,357,357,11,11,237,237,248,248,9454,9454
7,7,2020-10-26,2020-10-26,420,420,57,57,137,137,194,194,9648,9648
7,7,2020-10-27,2020-10-27,302,302,34,34,656,656,690,690,10338,10338
7,7,2020-10-28,2020-10-28,337,337,46,46,617,617,663,663,11001,11001
7,7,2020-10-29,2020-10-29,339,339,38,38,594,594,632,632,11633,11633
7,7,2020-10-30,2020-10-30,3014,3014,65,65,552,552,617,617,12250,12250
7,7,2020-10-31,2020-10-31,10667,10667,170,170,315,315,485,485,12735,12735
7,7,2020-11-01,2020-11-01,2959,2959,53,53,386,386,439,439,13174,13174
7,7,2020-11-02,2020-11-02,5162,5162,1004,1004,203,203,1207,1207,14381,14381
7,7,2020-11-03,2020-11-03,110,110,12,12,565,565,577,577,14958,14958
7,7,2020-11-04,2020-11-04,815,815,8,8,350,350,358,358,15316,15316
7,7,2020-11-05,2020-11-05,185,185,5,5,397,397,402,402,15718,15718
7,7,2020-11-06,2020-11-06,4867,4867,76,76,520,520,596,596,16314,16314
7,7,2020-11-07,2020-11-07,8659,8659,81,81,416,416,497,497,16811,16811
7,7,2020-11-08,2020-11-08,2849,2849,32,32,97,97,129,129,16940,16940
7,7,2020-11-09,2020-11-09,5051,5051,945,945,190,190,1135,1135,18075,18075
7,7,2020-11-10,2020-11-10,206,206,9,9,437,437,446,446,18521,18521
7,7,2020-11-11,2020-11-11,176,176,15,15,516,516,531,531,19052,19052
7,7,2020-11-12,2020-11-12,279,279,50,50,397,397,447,447,19499,19499
7,7,2020-11-13,2020-11-13,174,174,8,8,395,395,403,403,19902,19902
7,7,2020-11-14,2020-11-14,58,58,4,4,261,261,265,265,20167,20167
7,7,2020-11-15,2020-11-15,43,43,4,4,186,186,190,190,20357,20357
7,7,2020-11-16,2020-11-16,433,433,51,51,226,226,277,277,20634,20634
7,7,2020-11-17,2020-11-17,168,168,17,17,347,347,364,364,20998,20998
7,7,2020-11-18,2020-11-18,405,405,32,32,270,270,302,302,21300,21300
7,7,2020-11-19,2020-11-19,2202,2202,229,229,359,359,588,588,21888,21888
7,7,2020-11-20,2020-11-20,2161,2161,98,98,363,363,461,461,22349,22349
7,7,2020-11-21,2020-11-21,746,746,57,57,205,205,262,262,22611,22611
7,7,2020-11-22,2020-11-22,31,31,1,1,46,46,47,47,22658,22658
7,7,2020-11-23,2020-11-23,884,884,42,42,164,164,206,206,22864,22864
7,7,2020-11-24,2020-11-24,1802,1802,140,140,365,365,505,505,23369,23369
7,7,2020-11-25,2020-11-25,1720,1720,78,78,302,302,380,380,23749,23749
7,7,2020-11-26,2020-11-26,3099,3099,312,312,263,263,575,575,24324,24324
7,7,2020-11-27,2020-11-27,2254,2254,119,119,232,232,351,351,24675,24675
7,7,2020-11-28,2020-11-28,744,744,62,62,199,199,261,261,24936,24936
7,7,2020-11-29,2020-11-29,421,421,42,42,27,27,69,69,25005,25005
7,7,2020-11-30,2020-11-30,5931,5931,110,110,196,196,306,306,25311,25311
7,7,2020-12-01,2020-12-01,2554,2554,213,213,281,281,494,494,25805,25805
7,7,2020-12-02,2020-12-02,3486,3486,235,235,232,232,467,467,26272,26272
7,7,2020-12-03,2020-12-03,3102,3102,202,202,284,284,486,486,26758,26758
7,7,2020-12-04,2020-12-04,4752,4752,281,281,352,352,633,633,27391,27391
7,7,2020-12-05,2020-12-05,1071,1071,87,87,218,218,305,305,27696,27696
7,7,2020-12-06,2020-12-06,384,384,26,26,59,59,85,85,27781,27781
7,7,2020-12-07,2020-12-07,3981,3981,281,281,309,309,590,590,28371,28371
7,7,2020-12-08,2020-12-08,7083,7083,647,647,350,350,997,997,29368,29368
7,7,2020-12-09,2020-12-09,3916,3916,270,270,358,358,628,628,29996,29996
7,7,2020-12-10,2020-12-10,5620,5620,440,440,337,337,777,777,30773,30773
7,7,2020-12-11,2020-12-11,6460,6460,418,418,560,560,978,978,31751,31751
7,7,2020-12-12,2020-12-12,2640,2640,166,166,319,319,485,485,32236,32236
7,7,2020-12-13,2020-12-13,37,37,8,8,89,89,97,97,32333,32333
7,7,2020-12-14,2020-12-14,6275,6275,508,508,334,334,842,842,33175,33175
7,7,2020-12-15,2020-12-15,6269,6269,584,584,411,411,995,995,34170,34170
7,7,2020-12-16,2020-12-16,6525,6525,508,508,466,466,974,974,35144,35144
7,7,2020-12-17,2020-12-17,11717,11717,891,891,427,427,1318,1318,36462,36462
7,7,2020-12-18,2020-12-18,9449,9449,599,599,396,396,995,995,37457,37457
7,7,2020-12-19,2020-12-19,1809,1809,151,151,276,276,427,427,37884,37884
7,7,2020-12-20,2020-12-20,416,416,20,20,184,184,204,204,38088,38088
7,7,2020-12-21,2020-12-21,10216,10216,820,820,432,432,1252,1252,39340,39340
7,7,2020-12-22,2020-12-22,9471,9471,666,666,439,439,1105,1105,40445,40445
7,7,2020-12-23,2020-12-23,11010,11010,576,576,361,361,937,937,41382,41382
7,7,2020-12-24,2020-12-24,1299,1299,85,85,452,452,537,537,41919,41919
7,7,2020-12-25,2020-12-25,286,286,13,13,208,208,221,221,42140,42140
7,7,2020-12-26,2020-12-26,188,188,12,12,64,64,76,76,42216,42216
7,7,2020-12-27,2020-12-27,610,610,39,39,40,40,79,79,42295,42295
7,7,2020-12-28,2020-12-28,9312,9312,1020,1020,393,393,1413,1413,43708,43708
7,7,2020-12-29,2020-12-29,9149,9149,863,863,435,435,1298,1298,45006,45006
7,7,2020-12-30,2020-12-30,9015,9015,715,715,729,729,1444,1444,46450,46450
7,7,2020-12-31,2020-12-31,12194,12194,709,709,640,640,1349,1349,47799,47799
7,7,2021-01-01,2021-01-01,984,984,70,70,174,174,244,244,48043,48043
7,7,2021-01-02,2021-01-02,1719,1719,160,160,65,65,225,225,48268,48268
7,7,2021-01-03,2021-01-03,294,294,37,37,89,89,126,126,48394,48394
7,7,2021-01-04,2021-01-04,18088,18088,1688,1688,371,371,2059,2059,50453,50453
7,7,2021-01-05,2021-01-05,12041,12041,947,947,655,655,1602,1602,52055,52055
7,7,2021-01-06,2021-01-06,1360,1360,101,101,315,315,416,416,52471,52471
7,7,2021-01-07,2021-01-07,8008,8008,621,621,268,268,889,889,53360,53360
7,7,2021-01-08,2021-01-08,10576,10576,517,517,430,430,947,947,54307,54307
7,7,2021-01-09,2021-01-09,2373,2373,125,125,439,439,564,564,54871,54871
7,7,2021-01-10,2021-01-10,499,499,23,23,63,63,86,86,54957,54957
7,7,2021-01-11,2021-01-11,7643,7643,435,435,343,343,778,778,55735,55735
7,7,2021-01-12,2021-01-12,8469,8469,370,370,455,455,825,825,56560,56560
7,7,2021-01-13,2021-01-13,5502,5502,208,208,342,342,550,550,57110,57110
7,7,2021-01-14,2021-01-14,5488,5488,238,238,268,268,506,506,57616,57616
7,7,2021-01-15,2021-01-15,6531,6531,209,209,159,159,368,368,57984,57984
7,7,2021-01-16,2021-01-16,1659,1659,76,76,72,72,148,148,58132,58132
7,7,2021-01-17,2021-01-17,15401,15401,1008,1008,107,107,1115,1115,59247,59247
7,7,2021-01-18,2021-01-18,9764,9764,309,309,203,203,512,512,59759,59759
7,7,2021-01-19,2021-01-19,11294,11294,290,290,281,281,571,571,60330,60330
7,7,2021-01-20,2021-01-20,13200,13200,169,169,253,253,422,422,60752,60752
7,7,2021-01-21,2021-01-21,18869,18869,195,195,187,187,382,382,61134,61134
7,7,2021-01-22,2021-01-22,33716,33716,249,249,187,187,436,436,61570,61570
7,7,2021-01-23,2021-01-23,90280,90280,434,434,189,189,623,623,62193,62193
7,7,2021-01-24,2021-01-24,53344,53344,386,386,12,12,398,398,62591,62591
7,7,2021-01-25,2021-01-25,27965,27965,238,238,196,196,434,434,63025,63025
7,7,2021-01-26,2021-01-26,16101,16101,141,141,252,252,393,393,63418,63418
7,7,2021-01-27,2021-01-27,9487,9487,139,139,153,153,292,292,63710,63710
7,7,2021-01-28,2021-01-28,8344,8344,137,137,311,311,448,448,64158,64158
7,7,2021-01-29,2021-01-29,15810,15810,266,266,88,88,354,354,64512,64512
7,7,2021-01-30,2021-01-30,23988,23988,214,214,142,142,356,356,64868,64868
7,7,2021-01-31,2021-01-31,1661,1661,38,38,42,42,80,80,64948,64948
7,7,2021-02-01,2021-02-01,15479,15479,276,276,220,220,496,496,65444,65444
7,7,2021-02-02,2021-02-02,11778,11778,274,274,249,249,523,523,65967,65967
7,7,2021-02-03,2021-02-03,7764,7764,207,207,251,251,458,458,66425,66425
7,7,2021-02-04,2021-02-04,12162,12162,219,219,176,176,395,395,66820,66820
7,7,2021-02-05,2021-02-05,28005,28005,243,243,177,177,420,420,67240,67240
7,7,2021-02-06,2021-02-06,67146,67146,348,348,176,176,524,524,67764,67764
7,7,2021-02-07,2021-02-07,23442,23442,151,151,21,21,172,172,67936,67936
7,7,2021-02-08,2021-02-08,36564,36564,234,234,161,161,395,395,68331,68331
7,7,2021-02-09,2021-02-09,19727,19727,344,344,323,323,667,667,68998,68998
7,7,2021-02-10,2021-02-10,17207,17207,250,250,220,220,470,470,69468,69468
7,7,2021-02-11,2021-02-11,14242,14242,212,212,218,218,430,430,69898,69898
7,7,2021-02-12,2021-02-12,36878,36878,341,341,308,308,649,649,70547,70547
7,7,2021-02-13,2021-02-13,71951,71951,373,373,157,157,530,530,71077,71077
7,7,2021-02-14,2021-02-14,32131,32131,272,272,27,27,299,299,71376,71376
7,7,2021-02-15,2021-02-15,28520,28520,277,277,211,211,488,488,71864,71864
7,7,2021-02-16,2021-02-16,17381,17381,244,244,422,422,666,666,72530,72530
7,7,2021-02-17,2021-02-17,16168,16168,235,235,293,293,528,528,73058,73058
8,8,2020-09-03,2020-09-03,0,0,0,0,22,22,22,22,636,636
8,8,2020-09-04,2020-09-04,0,0,0,0,14,14,14,14,650,650
8,8,2020-09-05,2020-09-05,0,0,0,0,10,10,10,10,660,660
8,8,2020-09-06,2020-09-06,0,0,0,0,2,2,2,2,662,662
8,8,2020-09-07,2020-09-07,0,0,0,0,4,4,4,4,666,666
8,8,2020-09-08,2020-09-08,0,0,0,0,10,10,10,10,676,676
8,8,2020-09-09,2020-09-09,0,0,0,0,37,37,37,37,713,713
8,8,2020-09-10,2020-09-10,0,0,0,0,11,11,11,11,724,724
8,8,2020-09-11,2020-09-11,0,0,0,0,20,20,20,20,744,744
8,8,2020-09-12,2020-09-12,0,0,0,0,16,16,16,16,760,760
8,8,2020-09-13,2020-09-13,0,0,0,0,3,3,3,3,763,763
8,8,2020-09-14,2020-09-14,0,0,0,0,6,6,6,6,769,769
8,8,2020-09-15,2020-09-15,0,0,0,0,10,10,10,10,779,779
8,8,2020-09-16,2020-09-16,0,0,0,0,12,12,12,12,791,791
8,8,2020-09-17,2020-09-17,0,0,0,0,22,22,22,22,813,813
8,8,2020-09-18,2020-09-18,0,0,0,0,20,20,20,20,833,833
8,8,2020-09-19,2020-09-19,0,0,0,0,13,13,13,13,846,846
8,8,2020-09-20,2020-09-20,0,0,0,0,3,3,3,3,849,849
8,8,2020-09-21,2020-09-21,0,0,0,0,5,5,5,5,854,854
8,8,2020-09-22,2020-09-22,0,0,0,0,39,39,39,39,893,893
8,8,2020-09-23,2020-09-23,0,0,0,0,23,23,23,23,916,916
8,8,2020-09-24,2020-09-24,0,0,0,0,35,35,35,35,951,951
8,8,2020-09-25,2020-09-25,0,0,0,0,72,72,72,72,1023,1023
8,8,2020-09-26,2020-09-26,0,0,0,0,53,53,53,53,1076,1076
8,8,2020-09-27,2020-09-27,0,0,0,0,21,21,21,21,1097,1097
8,8,2020-09-28,2020-09-28,0,0,0,0,19,19,19,19,1116,1116
8,8,2020-09-29,2020-09-29,0,0,0,0,75,75,75,75,1191,1191
8,8,2020-09-30,2020-09-30,0,0,0,0,95,95,95,95,1286,1286
8,8,2020-10-01,2020-10-01,0,0,0,0,69,69,69,69,1355,1355
8,8,2020-10-02,2020-10-02,0,0,0,0,57,57,57,57,1412,1412
8,8,2020-10-03,2020-10-03,0,0,0,0,105,105,105,105,1517,1517
8,8,2020-10-04,2020-10-04,0,0,0,0,45,45,45,45,1562,1562
8,8,2020-10-05,2020-10-05,0,0,0,0,39,39,39,39,1601,1601
8,8,2020-10-06,2020-10-06,0,0,0,0,70,70,70,70,1671,1671
8,8,2020-10-07,2020-10-07,0,0,0,0,158,158,158,158,1829,1829
8,8,2020-10-08,2020-10-08,0,0,0,0,102,102,102,102,1931,1931
8,8,2020-10-09,2020-10-09,0,0,0,0,188,188,188,188,2119,2119
8,8,2020-10-10,2020-10-10,0,0,0,0,70,70,70,70,2189,2189
8,8,2020-10-11,2020-10-11,0,0,0,0,121,121,121,121,2310,2310
8,8,2020-10-12,2020-10-12,0,0,0,0,74,74,74,74,2384,2384
8,8,2020-10-13,2020-10-13,83,83,3,3,179,179,182,182,2566,2566
8,8,2020-10-14,2020-10-14,8,8,0,0,211,211,211,211,2777,2777
8,8,2020-10-15,2020-10-15,24,24,5,5,177,177,182,182,2959,2959
8,8,2020-10-16,2020-10-16,19,19,0,0,206,206,206,206,3165,3165
8,8,2020-10-17,2020-10-17,0,0,0,0,142,142,142,142,3307,3307
8,8,2020-10-18,2020-10-18,0,0,0,0,158,158,158,158,3465,3465
8,8,2020-10-19,2020-10-19,10,10,0,0,64,64,64,64,3529,3529
8,8,2020-10-20,2020-10-20,15,15,1,1,181,181,182,182,3711,3711
8,8,2020-10-21,2020-10-21,86,86,2,2,129,129,131,131,3842,3842
8,8,2020-10-22,2020-10-22,546,546,16,16,349,349,365,365,4207,4207
8,8,2020-10-23,2020-10-23,339,339,8,8,315,315,323,323,4530,4530
8,8,2020-10-24,2020-10-24,128,128,15,15,313,313,328,328,4858,4858
8,8,2020-10-25,2020-10-25,81,81,2,2,154,154,156,156,5014,5014
8,8,2020-10-26,2020-10-26,216,216,10,10,56,56,66,66,5080,5080
8,8,2020-10-27,2020-10-27,460,460,21,21,386,386,407,407,5487,5487
8,8,2020-10-28,2020-10-28,318,318,13,13,224,224,237,237,5724,5724
8,8,2020-10-29,2020-10-29,996,996,13,13,333,333,346,346,6070,6070
8,8,2020-10-30,2020-10-30,2862,2862,27,27,379,379,406,406,6476,6476
8,8,2020-10-31,2020-10-31,13915,13915,105,105,82,82,187,187,6663,6663
8,8,2020-11-01,2020-11-01,6556,6556,34,34,346,346,380,380,7043,7043
8,8,2020-11-02,2020-11-02,4419,4419,51,51,111,111,162,162,7205,7205
8,8,2020-11-03,2020-11-03,1135,1135,13,13,358,358,371,371,7576,7576
8,8,2020-11-04,2020-11-04,160,160,6,6,101,101,107,107,7683,7683
8,8,2020-11-05,2020-11-05,361,361,31,31,342,342,373,373,8056,8056
8,8,2020-11-06,2020-11-06,5344,5344,34,34,195,195,229,229,8285,8285
8,8,2020-11-07,2020-11-07,3931,3931,22,22,192,192,214,214,8499,8499
8,8,2020-11-08,2020-11-08,1306,1306,8,8,78,78,86,86,8585,8585
8,8,2020-11-09,2020-11-09,385,385,5,5,129,129,134,134,8719,8719
8,8,2020-11-10,2020-11-10,552,552,11,11,190,190,201,201,8920,8920
8,8,2020-11-11,2020-11-11,600,600,7,7,301,301,308,308,9228,9228
8,8,2020-11-12,2020-11-12,749,749,13,13,192,192,205,205,9433,9433
8,8,2020-11-13,2020-11-13,693,693,29,29,207,207,236,236,9669,9669
8,8,2020-11-14,2020-11-14,532,532,12,12,234,234,246,246,9915,9915
8,8,2020-11-15,2020-11-15,345,345,7,7,15,15,22,22,9937,9937
8,8,2020-11-16,2020-11-16,555,555,24,24,114,114,138,138,10075,10075
8,8,2020-11-17,2020-11-17,91,91,9,9,152,152,161,161,10236,10236
8,8,2020-11-18,2020-11-18,459,459,16,16,122,122,138,138,10374,10374
8,8,2020-11-19,2020-11-19,1688,1688,40,40,206,206,246,246,10620,10620
8,8,2020-11-20,2020-11-20,3034,3034,45,45,176,176,221,221,10841,10841
8,8,2020-11-21,2020-11-21,894,894,36,36,87,87,123,123,10964,10964
8,8,2020-11-22,2020-11-22,31,31,3,3,57,57,60,60,11024,11024
8,8,2020-11-23,2020-11-23,3791,3791,54,54,51,51,105,105,11129,11129
8,8,2020-11-24,2020-11-24,1935,1935,64,64,196,196,260,260,11389,11389
8,8,2020-11-25,2020-11-25,1786,1786,122,122,237,237,359,359,11748,11748
8,8,2020-11-26,2020-11-26,1145,1145,55,55,239,239,294,294,12042,12042
8,8,2020-11-27,2020-11-27,2803,2803,74,74,149,149,223,223,12265,12265
8,8,2020-11-28,2020-11-28,773,773,52,52,69,69,121,121,12386,12386
8,8,2020-11-29,2020-11-29,303,303,16,16,31,31,47,47,12433,12433
8,8,2020-11-30,2020-11-30,3816,3816,62,62,171,171,233,233,12666,12666
8,8,2020-12-01,2020-12-01,2361,2361,124,124,178,178,302,302,12968,12968
8,8,2020-12-02,2020-12-02,11536,11536,655,655,194,194,849,849,13817,13817
8,8,2020-12-03,2020-12-03,7890,7890,173,173,211,211,384,384,14201,14201
8,8,2020-12-04,2020-12-04,2762,2762,82,82,224,224,306,306,14507,14507
8,8,2020-12-05,2020-12-05,1144,1144,48,48,90,90,138,138,14645,14645
8,8,2020-12-06,2020-12-06,117,117,20,20,121,121,141,141,14786,14786
8,8,2020-12-07,2020-12-07,2214,2214,103,103,270,270,373,373,15159,15159
8,8,2020-12-08,2020-12-08,4460,4460,355,355,226,226,581,581,15740,15740
8,8,2020-12-09,2020-12-09,3952,3952,166,166,279,279,445,445,16185,16185
8,8,2020-12-10,2020-12-10,4240,4240,176,176,283,283,459,459,16644,16644
8,8,2020-12-11,2020-12-11,5719,5719,258,258,355,355,613,613,17257,17257
8,8,2020-12-12,2020-12-12,1705,1705,118,118,369,369,487,487,17744,17744
8,8,2020-12-13,2020-12-13,183,183,2,2,47,47,49,49,17793,17793
8,8,2020-12-14,2020-12-14,3132,3132,239,239,256,256,495,495,18288,18288
8,8,2020-12-15,2020-12-15,5424,5424,338,338,319,319,657,657,18945,18945
8,8,2020-12-16,2020-12-16,6214,6214,316,316,455,455,771,771,19716,19716
8,8,2020-12-17,2020-12-17,5547,5547,255,255,463,463,718,718,20434,20434
8,8,2020-12-18,2020-12-18,8810,8810,326,326,310,310,636,636,21070,21070
8,8,2020-12-19,2020-12-19,1207,1207,59,59,207,207,266,266,21336,21336
8,8,2020-12-20,2020-12-20,56,56,8,8,215,215,223,223,21559,21559
8,8,2020-12-21,2020-12-21,7493,7493,509,509,405,405,914,914,22473,22473
8,8,2020-12-22,2020-12-22,8379,8379,459,459,438,438,897,897,23370,23370
8,8,2020-12-23,2020-12-23,8296,8296,354,354,304,304,658,658,24028,24028
8,8,2020-12-24,2020-12-24,1560,1560,90,90,564,564,654,654,24682,24682
8,8,2020-12-25,2020-12-25,150,150,10,10,237,237,247,247,24929,24929
8,8,2020-12-26,2020-12-26,297,297,23,23,163,163,186,186,25115,25115
8,8,2020-12-27,2020-12-27,163,163,16,16,159,159,175,175,25290,25290
8,8,2020-12-28,2020-12-28,9100,9100,804,804,356,356,1160,1160,26450,26450
8,8,2020-12-29,2020-12-29,8178,8178,605,605,419,419,1024,1024,27474,27474
8,8,2020-12-30,2020-12-30,6889,6889,412,412,590,590,1002,1002,28476,28476
8,8,2020-12-31,2020-12-31,8338,8338,461,461,625,625,1086,1086,29562,29562
8,8,2021-01-01,2021-01-01,774,774,49,49,398,398,447,447,30009,30009
8,8,2021-01-02,2021-01-02,492,492,52,52,88,88,140,140,30149,30149
8,8,2021-01-03,2021-01-03,683,683,22,22,118,118,140,140,30289,30289
8,8,2021-01-04,2021-01-04,7512,7512,690,690,407,407,1097,1097,31386,31386
8,8,2021-01-05,2021-01-05,8106,8106,515,515,584,584,1099,1099,32485,32485
8,8,2021-01-06,2021-01-06,462,462,33,33,442,442,475,475,32960,32960
8,8,2021-01-07,2021-01-07,6540,6540,404,404,251,251,655,655,33615,33615
8,8,2021-01-08,2021-01-08,8321,8321,377,377,551,551,928,928,34543,34543
8,8,2021-01-09,2021-01-09,1179,1179,45,45,469,469,514,514,35057,35057
8,8,2021-01-10,2021-01-10,140,140,6,6,193,193,199,199,35256,35256
8,8,2021-01-11,2021-01-11,8065,8065,295,295,309,309,604,604,35860,35860
8,8,2021-01-12,2021-01-12,6802,6802,247,247,482,482,729,729,36589,36589
8,8,2021-01-13,2021-01-13,4999,4999,218,218,421,421,639,639,37228,37228
8,8,2021-01-14,2021-01-14,5544,5544,213,213,358,358,571,571,37799,37799
8,8,2021-01-15,2021-01-15,6481,6481,210,210,308,308,518,518,38317,38317
8,8,2021-01-16,2021-01-16,1450,1450,47,47,153,153,200,200,38517,38517
8,8,2021-01-17,2021-01-17,549,549,14,14,155,155,169,169,38686,38686
8,8,2021-01-18,2021-01-18,5611,5611,203,203,333,333,536,536,39222,39222
8,8,2021-01-19,2021-01-19,11098,11098,194,194,248,248,442,442,39664,39664
8,8,2021-01-20,2021-01-20,10715,10715,194,194,374,374,568,568,40232,40232
8,8,2021-01-21,2021-01-21,13803,13803,159,159,274,274,433,433,40665,40665
8,8,2021-01-22,2021-01-22,19936,19936,262,262,316,316,578,578,41243,41243
8,8,2021-01-23,2021-01-23,82859,82859,843,843,232,232,1075,1075,42318,42318
8,8,2021-01-24,2021-01-24,45045,45045,592,592,150,150,742,742,43060,43060
8,8,2021-01-25,2021-01-25,27653,27653,446,446,226,226,672,672,43732,43732
8,8,2021-01-26,2021-01-26,14149,14149,240,240,530,530,770,770,44502,44502
8,8,2021-01-27,2021-01-27,7440,7440,195,195,265,265,460,460,44962,44962
8,8,2021-01-28,2021-01-28,9066,9066,233,233,540,540,773,773,45735,45735
8,8,2021-01-29,2021-01-29,37264,37264,450,450,258,258,708,708,46443,46443
8,8,2021-01-30,2021-01-30,77658,77658,673,673,320,320,993,993,47436,47436
8,8,2021-01-31,2021-01-31,54259,54259,585,585,142,142,727,727,48163,48163
8,8,2021-02-01,2021-02-01,20355,20355,341,341,415,415,756,756,48919,48919
8,8,2021-02-02,2021-02-02,23710,23710,429,429,473,473,902,902,49821,49821
8,8,2021-02-03,2021-02-03,33460,33460,1101,1101,296,296,1397,1397,51218,51218
8,8,2021-02-04,2021-02-04,14470,14470,358,358,391,391,749,749,51967,51967
8,8,2021-02-05,2021-02-05,42196,42196,487,487,384,384,871,871,52838,52838
8,8,2021-02-06,2021-02-06,101446,101446,858,858,318,318,1176,1176,54014,54014
8,8,2021-02-07,2021-02-07,56952,56952,605,605,208,208,813,813,54827,54827
8,8,2021-02-08,2021-02-08,28798,28798,433,433,237,237,670,670,55497,55497
8,8,2021-02-09,2021-02-09,23962,23962,442,442,545,545,987,987,56484,56484
8,8,2021-02-10,2021-02-10,20360,20360,434,434,360,360,794,794,57278,57278
8,8,2021-02-11,2021-02-11,14389,14389,320,320,435,435,755,755,58033,58033
8,8,2021-02-12,2021-02-12,49407,49407,590,590,448,448,1038,1038,59071,59071
8,8,2021-02-13,2021-02-13,91042,91042,734,734,206,206,940,940,60011,60011
8,8,2021-02-14,2021-02-14,57035,57035,517,517,241,241,758,758,60769,60769
8,8,2021-02-15,2021-02-15,24456,24456,349,349,216,216,565,565,61334,61334
8,8,2021-02-16,2021-02-16,21677,21677,448,448,600,600,1048,1048,62382,62382
8,8,2021-02-17,2021-02-17,17596,17596,423,423,322,322,745,745,63127,63127
